CD_LOC;UF;abstencoes;aptos;comparecimentos;validos
SP00001;SP;3412;10045;6633;6086
SP00002;SP;2937;8476;5539;5059
SP00003;SP;2661;6223;3562;3191
SP00004;SP;1954;6071;4117;3653
SP00005;SP;2723;7574;4851;4286
SP00006;SP;1991;6187;4196;3800
SP00007;SP;4021;9748;5727;5077
SP00008;SP;1540;4250;2710;2422
SP00009;SP;1933;5809;3876;3552
SP00010;SP;3230;9269;6039;5553
SP00011;SP;2573;7822;5249;4769
SP00012;SP;3325;9441;6116;5498
SP00013;SP;1311;4269;2958;2742
SP00014;SP;2720;7153;4433;3934
SP00015;SP;1690;4890;3200;2777
SP00016;SP;1851;4976;3125;2763
SP00017;SP;2707;6847;4140;3704
SP00018;SP;1982;5238;3256;2906
SP00019;SP;1252;4798;3546;3272
SP00020;SP;502;1562;1060;914
SP00021;SP;1170;3914;2744;2386
SP00022;SP;1616;5474;3858;3218
SP00023;SP;581;2029;1448;1264
SP00024;SP;175;629;454;420
SP00025;SP;966;3193;2227;2052
SP00026;SP;458;1515;1057;941
SP00027;SP;1078;3011;1933;1784
SP00028;SP;2895;8070;5175;4726
SP00029;SP;5198;17797;12599;11769
SP00030;SP;987;2911;1924;1764
SP00031;SP;2144;6412;4268;3816
SP00032;SP;3484;11991;8507;8030
SP00033;SP;2464;7735;5271;4792
SP00034;SP;2155;5401;3246;2941
SP00035;SP;1749;5608;3859;3432
SP00036;SP;1940;6716;4776;4457
SP00037;SP;1524;5446;3922;3606
SP00038;SP;2394;8044;5650;5177
SP00039;SP;2055;6391;4336;3981
SP00040;SP;1854;7288;5434;4999
SP00041;SP;1394;4585;3191;2950
SP00042;SP;876;3797;2921;2677
SP00043;SP;857;3049;2192;1985
SP00044;SP;2046;7789;5743;5331
SP00045;SP;845;3377;2532;2298
SP00046;SP;2114;8211;6097;5678
SP00047;SP;1324;4672;3348;3050
SP00048;SP;1248;5609;4361;4021
SP00049;SP;713;2731;2018;1902
SP00050;SP;513;1956;1443;1344
SP00051;SP;3595;9919;6324;5895
SP00052;SP;2032;5165;3133;2746
SP00053;SP;2413;6007;3594;3140
SP00054;SP;1943;5696;3753;3197
SP00055;SP;2835;8226;5391;4660
SP00056;SP;2154;5794;3640;3156
SP00057;SP;1616;4525;2909;2485
SP00058;SP;1839;5387;3548;3095
SP00059;SP;2032;6072;4040;3525
SP00060;SP;2054;6204;4150;3582
SP00061;SP;1697;5110;3413;2995
SP00062;SP;1415;4386;2971;2589
SP00063;SP;1144;2961;1817;1572
SP00064;SP;2171;6208;4037;3511
SP00065;SP;1378;3705;2327;1980
SP00066;SP;1015;2941;1926;1623
SP00067;SP;577;1499;922;799
SP00068;SP;22;86;64;43
SP00069;SP;907;2939;2032;1793
SP00070;SP;1224;4221;2997;2670
SP00071;SP;2465;6547;4082;3615
SP00072;SP;1759;4862;3103;2736
SP00073;SP;5054;14871;9817;8895
SP00074;SP;1539;4599;3060;2770
SP00075;SP;844;2374;1530;1347
SP00076;SP;2611;7781;5170;4521
SP00077;SP;1602;5316;3714;3239
SP00078;SP;1674;6145;4471;4014
SP00079;SP;1627;6753;5126;4484
SP00080;SP;14;57;43;39
SP00081;SP;1791;4985;3194;2755
SP00082;SP;699;2042;1343;1191
SP00083;SP;3412;12710;9298;8373
SP00084;SP;2554;8514;5960;5282
SP00085;SP;2420;7942;5522;4861
SP00086;SP;1781;5934;4153;3692
SP00087;SP;2124;7025;4901;4319
SP00088;SP;2444;8110;5666;5056
SP00089;SP;2032;6261;4229;3816
SP00090;SP;1710;5982;4272;3906
SP00091;SP;2120;6781;4661;4098
SP00092;SP;2336;8010;5674;5030
SP00093;SP;1114;4638;3524;3163
SP00094;SP;1033;3713;2680;2357
SP00095;SP;1884;7262;5378;4657
SP00096;SP;1116;3961;2845;2437
SP00097;SP;1160;4480;3320;2831
SP00098;SP;1337;5038;3701;3156
SP00099;SP;1206;4550;3344;2841
SP00100;SP;1297;4225;2928;2539
SP00101;SP;2177;8957;6780;6001
SP00102;SP;1888;4710;2822;2446
SP00103;SP;745;2478;1733;1529
SP00104;SP;7;23;16;7
SP00105;SP;1240;3570;2330;2184
SP00106;SP;1728;4729;3001;2772
SP00107;SP;1653;5091;3438;3201
SP00108;SP;2710;7706;4996;4672
SP00109;SP;1263;3531;2268;2068
SP00110;SP;1471;4331;2860;2625
SP00111;SP;1692;5405;3713;3463
SP00112;SP;1806;5370;3564;3242
SP00113;SP;1454;4368;2914;2731
SP00114;SP;4244;11524;7280;6663
SP00115;SP;2119;6789;4670;4276
SP00116;SP;4649;13458;8809;8195
SP00117;SP;4232;12258;8026;7396
SP00118;SP;4044;11540;7496;6933
SP00119;SP;3070;8699;5629;5241
SP00120;SP;2439;7492;5053;4694
SP00121;SP;1388;4046;2658;2420
SP00122;SP;690;2338;1648;1510
SP00123;SP;631;2390;1759;1653
SP00124;SP;1721;5471;3750;3417
SP00125;SP;2713;8768;6055;5539
SP00126;SP;1182;3970;2788;2578
SP00127;SP;2179;7300;5121;4725
SP00128;SP;3284;9830;6546;5910
SP00129;SP;2412;8021;5609;5146
SP00130;SP;2393;7718;5325;4865
SP00131;SP;1415;5037;3622;3345
SP00132;SP;1560;4938;3378;3079
SP00133;SP;1286;4191;2905;2648
SP00134;SP;1774;5615;3841;3504
SP00135;SP;3246;10099;6853;5983
SP00136;SP;2744;9241;6497;5815
SP00137;SP;2003;6956;4953;4471
SP00138;SP;985;3114;2129;1891
SP00139;SP;2431;7945;5514;4905
SP00140;SP;1904;5793;3889;3467
SP00141;SP;1408;4594;3186;2804
SP00142;SP;1551;4541;2990;2638
SP00143;SP;2415;8101;5686;5122
SP00144;SP;1825;5788;3963;3611
SP00145;SP;1101;4652;3551;3217
SP00146;SP;1932;7336;5404;4752
SP00147;SP;1789;7272;5483;5016
SP00148;SP;1279;4985;3706;3293
SP00149;SP;862;3452;2590;2234
SP00150;SP;578;2320;1742;1615
SP00151;SP;1300;4988;3688;3066
SP00152;SP;316;857;541;441
SP00153;SP;1798;6503;4705;3830
SP00154;SP;2077;6876;4799;4025
SP00155;SP;1823;6109;4286;3668
SP00156;SP;2211;7080;4869;4038
SP00157;SP;559;1487;928;782
SP00158;SP;1915;5902;3987;3372
SP00159;SP;2448;8207;5759;4847
SP00160;SP;1818;7072;5254;4369
SP00161;SP;2001;7454;5453;4461
SP00162;SP;2083;7705;5622;4624
SP00163;SP;1642;6612;4970;4153
SP00164;SP;1500;5864;4364;3543
SP00165;SP;1270;5151;3881;3088
SP00166;SP;935;3724;2789;2307
SP00167;SP;1645;6528;4883;3930
SP00168;SP;1154;4204;3050;2550
SP00169;SP;1609;6507;4898;3997
SP00170;SP;928;3660;2732;2322
SP00171;SP;1563;6293;4730;3938
SP00172;SP;1110;4627;3517;2935
SP00173;SP;440;1568;1128;942
SP00174;SP;1050;4271;3221;2581
SP00175;SP;1305;4700;3395;2728
SP00176;SP;1195;4725;3530;2946
SP00177;SP;1671;6291;4620;3718
SP00178;SP;2189;8552;6363;5204
SP00179;SP;847;3023;2176;1776
SP00180;SP;723;2715;1992;1618
SP00181;SP;365;1188;823;662
SP00182;SP;222;780;558;444
SP00183;SP;436;1181;745;604
SP00184;SP;211;781;570;453
SP00185;SP;215;785;570;463
SP00186;SP;330;1134;804;667
SP00187;SP;237;792;555;428
SP00188;SP;1111;4302;3191;2652
SP00189;SP;1884;5717;3833;3381
SP00190;SP;2976;9191;6215;5565
SP00191;SP;1507;4893;3386;3120
SP00192;SP;1059;3326;2267;2028
SP00193;SP;1442;4453;3011;2715
SP00194;SP;2347;8615;6268;5780
SP00195;SP;1217;3523;2306;2013
SP00196;SP;923;3423;2500;2236
SP00197;SP;1489;4829;3340;3099
SP00198;SP;2789;9846;7057;6333
SP00199;SP;2654;9351;6697;6031
SP00200;SP;1339;4987;3648;3251
SP00201;SP;2887;9459;6572;5989
SP00202;SP;2504;7973;5469;5015
SP00203;SP;2168;7005;4837;4332
SP00204;SP;1040;4526;3486;3183
SP00205;SP;859;3126;2267;2107
SP00206;SP;797;3004;2207;2000
SP00207;SP;1099;4643;3544;3043
SP00208;SP;501;1780;1279;1147
SP00209;SP;1075;4117;3042;2774
SP00210;SP;559;2712;2153;1857
SP00211;SP;1706;6388;4682;4168
SP00212;SP;1462;5586;4124;3719
SP00213;SP;1278;4732;3454;3107
SP00214;SP;1482;5779;4297;3759
SP00215;SP;232;993;761;665
SP00216;SP;478;2036;1558;1384
SP00217;SP;322;1566;1244;1121
SP00218;SP;1008;3583;2575;2277
SP00219;SP;1607;5453;3846;3316
SP00220;SP;665;2119;1454;1292
SP00221;SP;975;3925;2950;2531
SP00222;SP;1593;5627;4034;3525
SP00223;SP;757;2666;1909;1662
SP00224;SP;1387;4682;3295;2841
SP00225;SP;1377;4793;3416;2882
SP00226;SP;1823;6504;4681;3905
SP00227;SP;1432;5078;3646;3077
SP00228;SP;1093;3772;2679;2265
SP00229;SP;1646;6362;4716;4007
SP00230;SP;1303;4442;3139;2668
SP00231;SP;992;4477;3485;2989
SP00232;SP;1658;6760;5102;4371
SP00233;SP;662;2180;1518;1306
SP00234;SP;294;1126;832;718
SP00235;SP;1626;6359;4733;4005
SP00236;SP;1082;4570;3488;2996
SP00237;SP;1175;4589;3414;2908
SP00238;SP;1341;6012;4671;3951
SP00239;SP;1353;5869;4516;3700
SP00240;SP;802;3251;2449;2056
SP00241;SP;885;3798;2913;2413
SP00242;SP;1014;4031;3017;2461
SP00243;SP;1182;3895;2713;2275
SP00244;SP;388;1594;1206;978
SP00245;SP;402;1860;1458;1167
SP00246;SP;152;730;578;471
SP00247;SP;683;3039;2356;1915
SP00248;SP;800;2993;2193;1833
SP00249;SP;996;3623;2627;2284
SP00250;SP;898;4023;3125;2566
SP00251;SP;998;3854;2856;2435
SP00252;SP;1210;4288;3078;2638
SP00253;SP;1512;6617;5105;4218
SP00254;SP;1222;4716;3494;2936
SP00255;SP;1734;6778;5044;4293
SP00256;SP;971;4254;3283;2674
SP00257;SP;1475;5556;4081;3166
SP00258;SP;716;2237;1521;1192
SP00259;SP;404;1803;1399;1139
SP00260;SP;2081;6967;4886;4112
SP00261;SP;1744;5727;3983;3376
SP00262;SP;1953;6791;4838;4128
SP00263;SP;2712;10873;8161;7067
SP00264;SP;1849;6606;4757;3973
SP00265;SP;1459;5313;3854;3315
SP00266;SP;1861;6960;5099;4318
SP00267;SP;1780;6197;4417;3682
SP00268;SP;1915;6330;4415;3742
SP00269;SP;1250;4567;3317;2813
SP00270;SP;1617;6129;4512;3803
SP00271;SP;1827;6516;4689;3929
SP00272;SP;740;3513;2773;2324
SP00273;SP;1225;5615;4390;3670
SP00274;SP;1056;5083;4027;3417
SP00275;SP;964;4248;3284;2804
SP00276;SP;965;4234;3269;2704
SP00277;SP;1055;4274;3219;2691
SP00278;SP;990;3874;2884;2434
SP00279;SP;1002;3855;2853;2307
SP00280;SP;1638;6493;4855;3966
SP00281;SP;1462;5656;4194;3612
SP00282;SP;1622;6521;4899;4004
SP00283;SP;1055;4282;3227;2653
SP00284;SP;1147;4514;3367;2775
SP00285;SP;563;2333;1770;1490
SP00286;SP;1546;6009;4463;3798
SP00287;SP;448;1938;1490;1274
SP00288;SP;605;2503;1898;1542
SP00289;SP;864;3751;2887;2359
SP00290;SP;488;2127;1639;1389
SP00291;SP;12;43;31;27
SP00292;SP;1238;3524;2286;2056
SP00293;SP;889;2607;1718;1522
SP00294;SP;1498;5157;3659;3309
SP00295;SP;1607;4636;3029;2673
SP00296;SP;804;2387;1583;1433
SP00297;SP;365;1311;946;845
SP00298;SP;1357;4475;3118;2813
SP00299;SP;614;2182;1568;1389
SP00300;SP;1324;5119;3795;3340
SP00301;SP;879;3036;2157;1924
SP00302;SP;1325;5488;4163;3804
SP00303;SP;1133;3512;2379;2163
SP00304;SP;957;3481;2524;2284
SP00305;SP;1103;2904;1801;1620
SP00306;SP;1628;5275;3647;3252
SP00307;SP;1173;3529;2356;2055
SP00308;SP;1364;4601;3237;2784
SP00309;SP;1118;3845;2727;2377
SP00310;SP;1668;5928;4260;3647
SP00311;SP;1533;4745;3212;2868
SP00312;SP;954;3428;2474;2235
SP00313;SP;1443;5494;4051;3634
SP00314;SP;838;2699;1861;1628
SP00315;SP;1585;5861;4276;3850
SP00316;SP;2278;8808;6530;5921
SP00317;SP;541;2042;1501;1271
SP00318;SP;730;2552;1822;1585
SP00319;SP;591;2366;1775;1580
SP00320;SP;1369;4504;3135;2784
SP00321;SP;1255;4314;3059;2771
SP00322;SP;2710;8258;5548;4975
SP00323;SP;1337;4008;2671;2414
SP00324;SP;1451;4770;3319;2949
SP00325;SP;1192;4286;3094;2780
SP00326;SP;1184;3933;2749;2471
SP00327;SP;497;1859;1362;1164
SP00328;SP;1044;3718;2674;2278
SP00329;SP;1139;3347;2208;1860
SP00330;SP;1189;4062;2873;2547
SP00331;SP;845;3036;2191;2021
SP00332;SP;770;3054;2284;2099
SP00333;SP;698;2049;1351;1203
SP00334;SP;430;1713;1283;1116
SP00335;SP;1126;4066;2940;2443
SP00336;SP;942;3224;2282;1932
SP00337;SP;377;1495;1118;942
SP00338;SP;1468;4592;3124;2780
SP00339;SP;1027;3299;2272;2075
SP00340;SP;1072;3747;2675;2391
SP00341;SP;881;3178;2297;2077
SP00342;SP;1461;5123;3662;3278
SP00343;SP;1483;5204;3721;3344
SP00344;SP;1731;5849;4118;3729
SP00345;SP;2470;7886;5416;4892
SP00346;SP;390;1595;1205;1113
SP00347;SP;822;3164;2342;2145
SP00348;SP;1278;4643;3365;3024
SP00349;SP;863;3642;2779;2310
SP00350;SP;317;1278;961;845
SP00351;SP;197;883;686;584
SP00352;SP;560;2374;1814;1639
SP00353;SP;705;2983;2278;2068
SP00354;SP;269;1134;865;715
SP00355;SP;422;1892;1470;1316
SP00356;SP;1681;6871;5190;4713
SP00357;SP;12;35;23;15
SP00358;SP;14;39;25;20
SP00359;SP;10;40;30;22
SP00360;SP;13;119;106;71
SP00361;SP;8;20;12;12
SP00362;SP;547;1767;1220;1081
SP00363;SP;2252;6587;4335;4017
SP00364;SP;646;1999;1353;1259
SP00365;SP;2077;5757;3680;3504
SP00366;SP;1688;5574;3886;3655
SP00367;SP;1138;3181;2043;1835
SP00368;SP;1396;4441;3045;2778
SP00369;SP;1247;4203;2956;2789
SP00370;SP;2002;7693;5691;5410
SP00371;SP;2241;7513;5272;4897
SP00372;SP;1902;5891;3989;3708
SP00373;SP;1632;5182;3550;3328
SP00374;SP;1341;4011;2670;2516
SP00375;SP;1404;4721;3317;3093
SP00376;SP;1451;4805;3354;3098
SP00377;SP;1166;4059;2893;2693
SP00378;SP;1095;3829;2734;2571
SP00379;SP;1364;4356;2992;2717
SP00380;SP;1413;4357;2944;2747
SP00381;SP;1388;4728;3340;3119
SP00382;SP;600;1970;1370;1292
SP00383;SP;1207;3490;2283;2113
SP00384;SP;798;2769;1971;1845
SP00385;SP;1130;3955;2825;2607
SP00386;SP;462;2170;1708;1625
SP00387;SP;733;3215;2482;2310
SP00388;SP;502;1990;1488;1379
SP00389;SP;721;2663;1942;1788
SP00390;SP;1179;4307;3128;2733
SP00391;SP;1102;3539;2437;2119
SP00392;SP;1290;4859;3569;3137
SP00393;SP;1149;3958;2809;2404
SP00394;SP;798;2651;1853;1621
SP00395;SP;2283;7319;5036;4255
SP00396;SP;966;2981;2015;1734
SP00397;SP;1178;4072;2894;2418
SP00398;SP;991;2787;1796;1541
SP00399;SP;1231;4200;2969;2600
SP00400;SP;650;2153;1503;1323
SP00401;SP;1789;6075;4286;3723
SP00402;SP;1138;4338;3200;2741
SP00403;SP;1906;6930;5024;4268
SP00404;SP;1488;5256;3768;3185
SP00405;SP;1165;4680;3515;3097
SP00406;SP;1108;3867;2759;2325
SP00407;SP;1156;4191;3035;2536
SP00408;SP;2088;7217;5129;4414
SP00409;SP;1391;5537;4146;3428
SP00410;SP;392;1624;1232;1026
SP00411;SP;411;1750;1339;1163
SP00412;SP;532;2247;1715;1480
SP00413;SP;1092;5079;3987;3298
SP00414;SP;512;2489;1977;1655
SP00415;SP;895;3888;2993;2599
SP00416;SP;393;1565;1172;969
SP00417;SP;334;1590;1256;1074
SP00418;SP;372;1339;967;784
SP00419;SP;1477;4961;3484;3096
SP00420;SP;416;1442;1026;925
SP00421;SP;867;3048;2181;1947
SP00422;SP;2725;10320;7595;6744
SP00423;SP;1355;4513;3158;2820
SP00424;SP;1374;4823;3449;3041
SP00425;SP;1674;6519;4845;4356
SP00426;SP;1966;6948;4982;4433
SP00427;SP;1191;4605;3414;3042
SP00428;SP;1699;5397;3698;3296
SP00429;SP;1519;5111;3592;3236
SP00430;SP;2158;8129;5971;5396
SP00431;SP;1295;4417;3122;2760
SP00432;SP;1210;3964;2754;2401
SP00433;SP;1142;4353;3211;2911
SP00434;SP;1576;5194;3618;3183
SP00435;SP;1757;7037;5280;4647
SP00436;SP;878;2845;1967;1697
SP00437;SP;1343;4783;3440;3049
SP00438;SP;930;3263;2333;2012
SP00439;SP;995;3746;2751;2414
SP00440;SP;1207;4147;2940;2548
SP00441;SP;1406;4817;3411;2965
SP00442;SP;720;3055;2335;2045
SP00443;SP;1422;5342;3920;3502
SP00444;SP;1007;4038;3031;2708
SP00445;SP;461;2263;1802;1578
SP00446;SP;1547;7010;5463;4823
SP00447;SP;939;4015;3076;2611
SP00448;SP;514;2058;1544;1354
SP00449;SP;1495;6333;4838;4289
SP00450;SP;1055;4825;3770;3407
SP00451;SP;422;1835;1413;1250
SP00452;SP;806;3018;2212;1929
SP00453;SP;348;1256;908;767
SP00454;SP;1915;6000;4085;3524
SP00455;SP;1209;4145;2936;2668
SP00456;SP;1225;4320;3095;2792
SP00457;SP;876;2816;1940;1732
SP00458;SP;2559;8529;5970;5339
SP00459;SP;1204;4392;3188;2896
SP00460;SP;1795;6386;4591;4104
SP00461;SP;1143;4042;2899;2649
SP00462;SP;1518;5168;3650;3226
SP00463;SP;366;1010;644;583
SP00464;SP;1104;4296;3192;2765
SP00465;SP;2123;7597;5474;4737
SP00466;SP;1649;6038;4389;3812
SP00467;SP;1476;5303;3827;3421
SP00468;SP;1476;5330;3854;3503
SP00469;SP;1594;5448;3854;3445
SP00470;SP;1427;4692;3265;2911
SP00471;SP;1018;3265;2247;1966
SP00472;SP;701;2507;1806;1593
SP00473;SP;1481;5477;3996;3538
SP00474;SP;1532;5075;3543;3133
SP00475;SP;1730;5821;4091;3609
SP00476;SP;1664;5975;4311;3817
SP00477;SP;860;2863;2003;1768
SP00478;SP;1001;3496;2495;2209
SP00479;SP;691;2742;2051;1807
SP00480;SP;523;1874;1351;1236
SP00481;SP;384;1516;1132;999
SP00482;SP;1768;6633;4865;4345
SP00483;SP;656;2523;1867;1612
SP00484;SP;828;3212;2384;2097
SP00485;SP;395;1466;1071;957
SP00486;SP;1108;4286;3178;2833
SP00487;SP;521;2063;1542;1295
SP00488;SP;418;1859;1441;1270
SP00489;SP;299;1525;1226;1101
SP00490;SP;653;1981;1328;1121
SP00491;SP;221;985;764;701
SP00492;SP;176;847;671;585
SP00493;SP;310;1172;862;755
SP00494;SP;22;54;32;26
SP00495;SP;14;54;40;23
SP00496;SP;1207;4579;3372;3009
SP00497;SP;1990;6925;4935;4441
SP00498;SP;947;3111;2164;1894
SP00499;SP;1930;6834;4904;4285
SP00500;SP;1850;6586;4736;4014
SP00501;SP;1436;4776;3340;2871
SP00502;SP;1898;6808;4910;4207
SP00503;SP;1985;6619;4634;4034
SP00504;SP;963;4008;3045;2673
SP00505;SP;653;2185;1532;1335
SP00506;SP;1254;4319;3065;2647
SP00507;SP;2618;9953;7335;6265
SP00508;SP;1490;5317;3827;3334
SP00509;SP;1394;4399;3005;2554
SP00510;SP;1880;6209;4329;3594
SP00511;SP;2064;6942;4878;4132
SP00512;SP;2226;7389;5163;4319
SP00513;SP;1113;4106;2993;2609
SP00514;SP;1524;5514;3990;3430
SP00515;SP;1248;4792;3544;3046
SP00516;SP;2061;6938;4877;4090
SP00517;SP;1044;3694;2650;2223
SP00518;SP;1477;4780;3303;2826
SP00519;SP;1725;5846;4121;3509
SP00520;SP;880;3065;2185;1832
SP00521;SP;1512;5002;3490;2901
SP00522;SP;1176;4695;3519;2921
SP00523;SP;1061;4290;3229;2690
SP00524;SP;715;2811;2096;1775
SP00525;SP;1400;5945;4545;3796
SP00526;SP;817;3210;2393;2007
SP00527;SP;630;3105;2475;2136
SP00528;SP;589;2366;1777;1569
SP00529;SP;786;3155;2369;2087
SP00530;SP;357;1521;1164;979
SP00531;SP;1705;6972;5267;4395
SP00532;SP;735;2674;1939;1655
SP00533;SP;557;2644;2087;1800
SP00534;SP;942;4351;3409;3003
SP00535;SP;1569;4936;3367;2995
SP00536;SP;1749;6329;4580;3965
SP00537;SP;1313;4344;3031;2660
SP00538;SP;1666;5278;3612;3064
SP00539;SP;1836;5948;4112;3697
SP00540;SP;1083;3175;2092;1863
SP00541;SP;1083;3175;2092;1863
SP00542;SP;1451;4842;3391;2867
SP00543;SP;2618;8077;5459;4653
SP00544;SP;1829;5536;3707;3265
SP00545;SP;2233;7097;4864;4172
SP00546;SP;1495;4580;3085;2705
SP00547;SP;916;3238;2322;2051
SP00548;SP;1450;4404;2954;2590
SP00549;SP;1918;5928;4010;3526
SP00550;SP;1329;4742;3413;2933
SP00551;SP;1327;4597;3270;2815
SP00552;SP;1909;5887;3978;3352
SP00553;SP;1552;4676;3124;2659
SP00554;SP;1397;5499;4102;3446
SP00555;SP;978;3492;2514;2184
SP00556;SP;469;1967;1498;1290
SP00557;SP;1586;5966;4380;3694
SP00558;SP;1433;5547;4114;3404
SP00559;SP;1748;6869;5121;4262
SP00560;SP;1312;4755;3443;2876
SP00561;SP;1212;4720;3508;2955
SP00562;SP;817;3269;2452;2120
SP00563;SP;1024;3945;2921;2409
SP00564;SP;1630;6019;4389;3561
SP00565;SP;792;3148;2356;2001
SP00566;SP;972;3965;2993;2499
SP00567;SP;1099;3964;2865;2570
SP00568;SP;1167;4355;3188;2856
SP00569;SP;640;2316;1676;1426
SP00570;SP;371;1547;1176;988
SP00571;SP;496;1966;1470;1235
SP00572;SP;1425;5117;3692;3011
SP00573;SP;300;1187;887;742
SP00574;SP;1552;4916;3364;2734
SP00575;SP;606;1945;1339;1078
SP00576;SP;0;45;45;42
SP00577;SP;2573;8415;5842;5257
SP00578;SP;711;2949;2238;2000
SP00579;SP;1251;4397;3146;2698
SP00580;SP;880;3133;2253;2017
SP00581;SP;1534;5307;3773;3338
SP00582;SP;1178;4259;3081;2707
SP00583;SP;1316;4985;3669;3192
SP00584;SP;760;2542;1782;1552
SP00585;SP;1428;4746;3318;2911
SP00586;SP;639;2592;1953;1703
SP00587;SP;1111;3697;2586;2332
SP00588;SP;1646;5167;3521;3105
SP00589;SP;1403;4702;3299;2808
SP00590;SP;2299;7580;5281;4546
SP00591;SP;1863;6263;4400;3772
SP00592;SP;1502;5506;4004;3466
SP00593;SP;1462;5605;4143;3635
SP00594;SP;974;3522;2548;2172
SP00595;SP;971;3557;2586;2244
SP00596;SP;938;3534;2596;2206
SP00597;SP;1503;5301;3798;3190
SP00598;SP;1411;4844;3433;2954
SP00599;SP;1909;6251;4342;3651
SP00600;SP;1116;4185;3069;2605
SP00601;SP;1747;6122;4375;3842
SP00602;SP;1002;3850;2848;2482
SP00603;SP;1499;4959;3460;2923
SP00604;SP;943;3537;2594;2222
SP00605;SP;941;4399;3458;2999
SP00606;SP;520;2414;1894;1650
SP00607;SP;605;2771;2166;1868
SP00608;SP;823;3524;2701;2326
SP00609;SP;468;2139;1671;1413
SP00610;SP;1119;4996;3877;3393
SP00611;SP;403;1902;1499;1287
SP00612;SP;624;2164;1540;1327
SP00613;SP;270;1184;914;787
SP00614;SP;1575;6485;4910;4153
SP00615;SP;219;1062;843;710
SP00616;SP;883;3937;3054;2687
SP00617;SP;393;1349;956;839
SP00618;SP;1727;5671;3944;3400
SP00619;SP;465;1692;1227;1055
SP00620;SP;33;98;65;44
SP00621;SP;2410;7468;5058;4641
SP00622;SP;2632;8525;5893;5358
SP00623;SP;1794;5777;3983;3670
SP00624;SP;2013;6339;4326;3981
SP00625;SP;3154;10784;7630;7038
SP00626;SP;1952;6265;4313;3939
SP00627;SP;2327;7090;4763;4286
SP00628;SP;2215;7913;5698;5302
SP00629;SP;1253;3705;2452;2194
SP00630;SP;1740;5514;3774;3466
SP00631;SP;951;2522;1571;1400
SP00632;SP;2717;9851;7134;6537
SP00633;SP;1159;3955;2796;2560
SP00634;SP;2134;6679;4545;4143
SP00635;SP;1863;5917;4054;3591
SP00636;SP;2262;7155;4893;4473
SP00637;SP;2102;5885;3783;3470
SP00638;SP;2164;6804;4640;4208
SP00639;SP;2755;9027;6272;5745
SP00640;SP;1973;6187;4214;3845
SP00641;SP;2280;6983;4703;4242
SP00642;SP;1296;5042;3746;3356
SP00643;SP;895;3354;2459;2145
SP00644;SP;1585;5516;3931;3555
SP00645;SP;1162;3823;2661;2407
SP00646;SP;950;3531;2581;2320
SP00647;SP;2320;7403;5083;4634
SP00648;SP;964;3841;2877;2605
SP00649;SP;666;2648;1982;1760
SP00650;SP;1154;4689;3535;3191
SP00651;SP;1581;4603;3022;2669
SP00652;SP;1355;4711;3356;2915
SP00653;SP;2887;9758;6871;6317
SP00654;SP;1670;5621;3951;3632
SP00655;SP;1226;4274;3048;2819
SP00656;SP;2117;7540;5423;4936
SP00657;SP;1929;6658;4729;4302
SP00658;SP;1344;4399;3055;2774
SP00659;SP;1223;4066;2843;2587
SP00660;SP;535;1900;1365;1239
SP00661;SP;1203;3498;2295;2021
SP00662;SP;1275;4467;3192;2948
SP00663;SP;1509;4883;3374;3029
SP00664;SP;1238;4189;2951;2669
SP00665;SP;1454;4690;3236;2925
SP00666;SP;1560;4794;3234;2902
SP00667;SP;1994;7365;5371;4835
SP00668;SP;1578;5384;3806;3465
SP00669;SP;1217;4307;3090;2819
SP00670;SP;1547;5766;4219;3799
SP00671;SP;2383;7344;4961;4380
SP00672;SP;1545;5404;3859;3453
SP00673;SP;1015;3585;2570;2364
SP00674;SP;814;3396;2582;2220
SP00675;SP;465;2186;1721;1556
SP00676;SP;914;3751;2837;2529
SP00677;SP;418;1922;1504;1376
SP00678;SP;962;3777;2815;2493
SP00679;SP;1287;4304;3017;2683
SP00680;SP;2792;11486;8694;7821
SP00681;SP;1234;5137;3903;3542
SP00682;SP;547;2306;1759;1584
SP00683;SP;1179;5169;3990;3629
SP00684;SP;394;1542;1148;1039
SP00685;SP;56;329;273;250
SP00686;SP;3129;9715;6586;5733
SP00687;SP;1613;5282;3669;3211
SP00688;SP;1209;4013;2804;2484
SP00689;SP;1864;6259;4395;3885
SP00690;SP;1691;5510;3819;3318
SP00691;SP;674;2030;1356;1186
SP00692;SP;2303;8151;5848;5192
SP00693;SP;1383;4634;3251;2869
SP00694;SP;2246;8474;6228;5583
SP00695;SP;1804;5738;3934;3443
SP00696;SP;315;1384;1069;972
SP00697;SP;1157;4338;3181;2881
SP00698;SP;1247;4269;3022;2595
SP00699;SP;865;2845;1980;1691
SP00700;SP;742;2038;1296;1148
SP00701;SP;1071;4091;3020;2626
SP00702;SP;1018;3281;2263;2012
SP00703;SP;1073;3713;2640;2200
SP00704;SP;1567;5896;4329;3685
SP00705;SP;775;2464;1689;1474
SP00706;SP;1502;5478;3976;3402
SP00707;SP;2008;6988;4980;4238
SP00708;SP;1758;5710;3952;3354
SP00709;SP;1707;5869;4162;3614
SP00710;SP;1106;3923;2817;2427
SP00711;SP;1283;4783;3500;3017
SP00712;SP;1942;7054;5112;4323
SP00713;SP;1367;5464;4097;3538
SP00714;SP;833;3081;2248;1931
SP00715;SP;1009;4628;3619;3057
SP00716;SP;1345;6085;4740;4111
SP00717;SP;1221;5351;4130;3567
SP00718;SP;1113;3625;2512;2090
SP00719;SP;1771;6130;4359;3647
SP00720;SP;425;2043;1618;1422
SP00721;SP;857;3054;2197;1978
SP00722;SP;692;3108;2416;2060
SP00723;SP;1401;5496;4095;3502
SP00724;SP;965;3664;2699;2432
SP00725;SP;1725;5899;4174;3691
SP00726;SP;1443;4468;3025;2675
SP00727;SP;1398;5267;3869;3416
SP00728;SP;1290;4919;3629;3093
SP00729;SP;2176;8105;5929;5111
SP00730;SP;1349;5502;4153;3563
SP00731;SP;1219;4685;3466;3004
SP00732;SP;985;3768;2783;2391
SP00733;SP;1601;6587;4986;4131
SP00734;SP;959;3871;2912;2509
SP00735;SP;1490;5909;4419;3878
SP00736;SP;1422;6501;5079;4352
SP00737;SP;1419;6265;4846;4149
SP00738;SP;1968;8744;6776;5693
SP00739;SP;431;1868;1437;1249
SP00740;SP;868;3936;3068;2621
SP00741;SP;927;4300;3373;2832
SP00742;SP;1087;5088;4001;3393
SP00743;SP;994;4240;3246;2798
SP00744;SP;1231;5446;4215;3568
SP00745;SP;1233;4714;3481;3072
SP00746;SP;312;1614;1302;1139
SP00747;SP;1163;4941;3778;3217
SP00748;SP;1033;3624;2591;2215
SP00749;SP;416;1955;1539;1305
SP00750;SP;301;1353;1052;900
SP00751;SP;431;1977;1546;1291
SP00752;SP;882;3263;2381;1917
SP00753;SP;351;1731;1380;1171
SP00754;SP;166;1139;973;857
SP00755;SP;701;2817;2116;1822
SP00756;SP;957;3235;2278;1971
SP00757;SP;761;3284;2523;2167
SP00758;SP;900;4241;3341;2876
SP00759;SP;796;3490;2694;2242
SP00760;SP;1771;6093;4322;3614
SP00761;SP;887;3317;2430;2099
SP00762;SP;924;4199;3275;2719
SP00763;SP;618;2894;2276;1887
SP00764;SP;257;1319;1062;886
SP00765;SP;2514;8135;5621;4929
SP00766;SP;2085;7053;4968;4402
SP00767;SP;1983;6440;4457;3930
SP00768;SP;1362;4292;2930;2636
SP00769;SP;1614;5078;3464;3068
SP00770;SP;1947;6150;4203;3615
SP00771;SP;2272;7436;5164;4500
SP00772;SP;1547;5664;4117;3538
SP00773;SP;1838;6264;4426;3805
SP00774;SP;2062;7854;5792;5026
SP00775;SP;2144;7449;5305;4528
SP00776;SP;1902;6598;4696;4003
SP00777;SP;1815;5853;4038;3381
SP00778;SP;2212;7392;5180;4241
SP00779;SP;2024;7813;5789;4877
SP00780;SP;877;3820;2943;2559
SP00781;SP;1188;4179;2991;2524
SP00782;SP;1694;6626;4932;4068
SP00783;SP;239;823;584;517
SP00784;SP;776;3105;2329;1939
SP00785;SP;448;1882;1434;1271
SP00786;SP;1137;4539;3402;2835
SP00787;SP;569;2366;1797;1532
SP00788;SP;1808;6979;5171;4203
SP00789;SP;436;1625;1189;1067
SP00790;SP;384;1404;1020;912
SP00791;SP;305;1168;863;759
SP00792;SP;696;2736;2040;1747
SP00793;SP;602;2523;1921;1605
SP00794;SP;1415;5472;4057;3352
SP00795;SP;1361;5107;3746;3093
SP00796;SP;291;1001;710;595
SP00797;SP;1027;3693;2666;2284
SP00798;SP;790;3561;2771;2464
SP00799;SP;2163;7792;5629;4646
SP00800;SP;1398;5404;4006;3410
SP00801;SP;909;3726;2817;2456
SP00802;SP;586;2293;1707;1374
SP00803;SP;970;3495;2525;2040
SP00804;SP;358;1445;1087;869
SP00805;SP;2003;6882;4879;4246
SP00806;SP;1563;5119;3556;3097
SP00807;SP;1278;4221;2943;2555
SP00808;SP;1605;5967;4362;3844
SP00809;SP;1247;4931;3684;3295
SP00810;SP;1287;4312;3025;2622
SP00811;SP;1468;4790;3322;2896
SP00812;SP;2030;6537;4507;3857
SP00813;SP;1690;5405;3715;3298
SP00814;SP;1069;3409;2340;2047
SP00815;SP;1456;4827;3371;2943
SP00816;SP;1333;4010;2677;2281
SP00817;SP;1526;5075;3549;2989
SP00818;SP;1051;4699;3648;3126
SP00819;SP;325;1557;1232;1066
SP00820;SP;742;2998;2256;1983
SP00821;SP;803;3156;2353;2019
SP00822;SP;454;1894;1440;1247
SP00823;SP;669;2754;2085;1805
SP00824;SP;1303;5510;4207;3616
SP00825;SP;881;3960;3079;2727
SP00826;SP;494;2231;1737;1498
SP00827;SP;1826;7530;5704;4991
SP00828;SP;4;40;36;35
SP00829;SP;270;1366;1096;992
SP00830;SP;378;1919;1541;1355
SP00831;SP;732;3038;2306;1971
SP00832;SP;1251;4365;3114;2744
SP00833;SP;1422;5058;3636;3107
SP00834;SP;917;3451;2534;2279
SP00835;SP;1245;4136;2891;2501
SP00836;SP;1498;4922;3424;2884
SP00837;SP;485;2272;1787;1553
SP00838;SP;1212;4893;3681;3136
SP00839;SP;248;942;694;608
SP00840;SP;198;990;792;676
SP00841;SP;1583;6587;5004;4195
SP00842;SP;1972;6278;4306;3669
SP00843;SP;1709;5641;3932;3203
SP00844;SP;378;1541;1163;977
SP00845;SP;411;1830;1419;1181
SP00846;SP;2053;7352;5299;4323
SP00847;SP;1026;4082;3056;2550
SP00848;SP;1617;5251;3634;3006
SP00849;SP;796;3277;2481;2090
SP00850;SP;1407;5224;3817;3220
SP00851;SP;1798;5695;3897;3271
SP00852;SP;447;1783;1336;1128
SP00853;SP;1041;4081;3040;2553
SP00854;SP;1830;6049;4219;3570
SP00855;SP;889;3058;2169;1851
SP00856;SP;1524;6062;4538;3805
SP00857;SP;683;3507;2824;2367
SP00858;SP;1507;6096;4589;3794
SP00859;SP;1029;4366;3337;2773
SP00860;SP;665;3076;2411;1994
SP00861;SP;894;3884;2990;2383
SP00862;SP;1121;4149;3028;2481
SP00863;SP;879;3714;2835;2384
SP00864;SP;477;2151;1674;1405
SP00865;SP;1252;5331;4079;3454
SP00866;SP;504;2305;1801;1511
SP00867;SP;469;2195;1726;1441
SP00868;SP;1162;4537;3375;2769
SP00869;SP;574;2469;1895;1521
SP00870;SP;347;1214;867;691
SP00871;SP;1009;4180;3171;2619
SP00872;SP;1187;4150;2963;2373
SP00873;SP;1589;5220;3631;3139
SP00874;SP;884;3637;2753;2278
SP00875;SP;999;4489;3490;2842
SP00876;SP;1072;4758;3686;3039
SP00877;SP;570;2332;1762;1425
SP00878;SP;1043;4052;3009;2553
SP00879;SP;1597;5137;3540;2959
SP00880;SP;942;4156;3214;2672
SP00881;SP;275;1173;898;759
SP00882;SP;471;1968;1497;1197
SP00883;SP;334;1492;1158;940
SP00884;SP;1908;6025;4117;3528
SP00885;SP;1064;3760;2696;2288
SP00886;SP;1095;3614;2519;2153
SP00887;SP;771;2549;1778;1536
SP00888;SP;803;3225;2422;2160
SP00889;SP;1287;4118;2831;2529
SP00890;SP;1836;6506;4670;4087
SP00891;SP;1571;6195;4624;4037
SP00892;SP;1413;4485;3072;2701
SP00893;SP;1252;4866;3614;3170
SP00894;SP;1201;4335;3134;2776
SP00895;SP;1486;4545;3059;2625
SP00896;SP;1125;3683;2558;2191
SP00897;SP;1112;4232;3120;2666
SP00898;SP;1363;4477;3114;2686
SP00899;SP;930;3360;2430;2195
SP00900;SP;1238;4799;3561;2989
SP00901;SP;1226;4411;3185;2668
SP00902;SP;870;3771;2901;2421
SP00903;SP;436;1833;1397;1247
SP00904;SP;302;1355;1053;902
SP00905;SP;1315;5577;4262;3604
SP00906;SP;392;1659;1267;1089
SP00907;SP;842;3598;2756;2283
SP00908;SP;507;2080;1573;1325
SP00909;SP;546;2198;1652;1447
SP00910;SP;170;884;714;633
SP00911;SP;741;2895;2154;1865
SP00912;SP;523;2322;1799;1573
SP00913;SP;879;3776;2897;2382
SP00914;SP;216;1086;870;721
SP00915;SP;460;1861;1401;1187
SP00916;SP;316;1311;995;820
SP00917;SP;64;310;246;213
SP00918;SP;374;1646;1272;1081
SP00919;SP;253;1249;996;833
SP00920;SP;1844;6672;4828;3916
SP00921;SP;359;1221;862;673
SP00922;SP;2549;8638;6089;5158
SP00923;SP;1881;5779;3898;3357
SP00924;SP;1666;5898;4232;3558
SP00925;SP;1463;5327;3864;3310
SP00926;SP;1640;5575;3935;3387
SP00927;SP;1295;4583;3288;2862
SP00928;SP;1183;5132;3949;3288
SP00929;SP;575;2588;2013;1723
SP00930;SP;658;2858;2200;1854
SP00931;SP;355;1575;1220;1064
SP00932;SP;830;3504;2674;2191
SP00933;SP;1776;6037;4261;3621
SP00934;SP;1547;5284;3737;3064
SP00935;SP;1948;6922;4974;4152
SP00936;SP;1905;6913;5008;4173
SP00937;SP;1493;5631;4138;3493
SP00938;SP;2227;7741;5514;4610
SP00939;SP;1846;6851;5005;4282
SP00940;SP;2241;7378;5137;4304
SP00941;SP;2262;8289;6027;5126
SP00942;SP;1483;6510;5027;4307
SP00943;SP;1498;5578;4080;3484
SP00944;SP;1830;6614;4784;3934
SP00945;SP;1708;6631;4923;4190
SP00946;SP;1104;4553;3449;2787
SP00947;SP;1664;6568;4904;4056
SP00948;SP;1470;6371;4901;3965
SP00949;SP;1602;6028;4426;3627
SP00950;SP;1701;6838;5137;4204
SP00951;SP;1636;6758;5122;4246
SP00952;SP;4403;13315;8912;7365
SP00953;SP;1633;6513;4880;4005
SP00954;SP;1257;4954;3697;3067
SP00955;SP;1047;4285;3238;2757
SP00956;SP;1875;6086;4211;3458
SP00957;SP;1676;6423;4747;3930
SP00958;SP;2066;5350;3284;2681
SP00959;SP;2018;7126;5108;4199
SP00960;SP;1043;3791;2748;2254
SP00961;SP;353;1021;668;532
SP00962;SP;213;709;496;397
SP00963;SP;171;706;535;445
SP00964;SP;3873;11909;8036;7407
SP00965;SP;1857;6230;4373;3908
SP00966;SP;1417;4337;2920;2568
SP00967;SP;1294;4335;3041;2679
SP00968;SP;1631;5544;3913;3471
SP00969;SP;1629;5494;3865;3305
SP00970;SP;1358;4314;2956;2665
SP00971;SP;1411;4461;3050;2736
SP00972;SP;1777;5527;3750;3325
SP00973;SP;1310;4361;3051;2752
SP00974;SP;1090;3974;2884;2635
SP00975;SP;1857;5925;4068;3551
SP00976;SP;825;3374;2549;2299
SP00977;SP;1431;4747;3316;2910
SP00978;SP;1370;4720;3350;2972
SP00979;SP;997;3936;2939;2570
SP00980;SP;1390;4362;2972;2771
SP00981;SP;1624;4660;3036;2763
SP00982;SP;1676;5546;3870;3467
SP00983;SP;1170;4483;3313;2925
SP00984;SP;616;2369;1753;1559
SP00985;SP;806;3154;2348;2069
SP00986;SP;661;2746;2085;1796
SP00987;SP;1255;4690;3435;2890
SP00988;SP;1292;5130;3838;3440
SP00989;SP;1261;4732;3471;3057
SP00990;SP;806;3164;2358;2053
SP00991;SP;1011;3538;2527;2242
SP00992;SP;455;1966;1511;1290
SP00993;SP;354;1554;1200;998
SP00994;SP;849;3170;2321;2062
SP00995;SP;870;3591;2721;2468
SP00996;SP;403;1564;1161;1021
SP00997;SP;106;391;285;259
SP00998;SP;212;790;578;529
SP00999;SP;215;789;574;472
SP01000;SP;1632;5650;4018;3607
SP01001;SP;1706;5804;4098;3731
SP01002;SP;1101;3956;2855;2507
SP01003;SP;1491;6014;4523;4108
SP01004;SP;2534;8670;6136;5546
SP01005;SP;1664;5082;3418;3092
SP01006;SP;1284;5115;3831;3413
SP01007;SP;922;3314;2392;2070
SP01008;SP;957;3674;2717;2363
SP01009;SP;800;3257;2457;2139
SP01010;SP;756;2767;2011;1774
SP01011;SP;1111;4250;3139;2753
SP01012;SP;2702;9040;6338;5575
SP01013;SP;1487;5581;4094;3585
SP01014;SP;936;3487;2551;2157
SP01015;SP;1517;5212;3695;3226
SP01016;SP;2241;7681;5440;4570
SP01017;SP;1228;3849;2621;2231
SP01018;SP;1287;4200;2913;2462
SP01019;SP;864;3579;2715;2251
SP01020;SP;353;1678;1325;1100
SP01021;SP;1808;5856;4048;3411
SP01022;SP;1890;7237;5347;4505
SP01023;SP;1545;5047;3502;2993
SP01024;SP;305;1053;748;632
SP01025;SP;1156;3899;2743;2367
SP01026;SP;1309;4576;3267;2774
SP01027;SP;963;3926;2963;2463
SP01028;SP;1259;4443;3184;2685
SP01029;SP;766;3145;2379;1989
SP01030;SP;745;3473;2728;2337
SP01031;SP;978;4290;3312;2843
SP01032;SP;1201;4988;3787;3216
SP01033;SP;1041;4681;3640;3143
SP01034;SP;986;3909;2923;2528
SP01035;SP;1734;6691;4957;4181
SP01036;SP;941;4224;3283;2773
SP01037;SP;1256;5057;3801;3294
SP01038;SP;824;3517;2693;2279
SP01039;SP;913;3823;2910;2407
SP01040;SP;918;3542;2624;2319
SP01041;SP;345;1390;1045;903
SP01042;SP;1102;4324;3222;2725
SP01043;SP;357;1572;1215;1043
SP01044;SP;1083;4726;3643;3151
SP01045;SP;1144;4702;3558;2953
SP01046;SP;359;1567;1208;1036
SP01047;SP;622;2728;2106;1772
SP01048;SP;366;1647;1281;1090
SP01049;SP;554;2385;1831;1538
SP01050;SP;456;1959;1503;1281
SP01051;SP;720;3156;2436;2042
SP01052;SP;1772;6139;4367;3809
SP01053;SP;1807;5114;3307;2816
SP01054;SP;1323;4275;2952;2509
SP01055;SP;1632;5802;4170;3541
SP01056;SP;1835;6196;4361;3772
SP01057;SP;1629;6658;5029;4330
SP01058;SP;1477;5074;3597;3098
SP01059;SP;1382;5785;4403;3766
SP01060;SP;1416;5345;3929;3417
SP01061;SP;1179;4129;2950;2515
SP01062;SP;916;2994;2078;1770
SP01063;SP;1259;4282;3023;2516
SP01064;SP;1568;6076;4508;3796
SP01065;SP;1006;3662;2656;2330
SP01066;SP;741;2883;2142;1859
SP01067;SP;752;3428;2676;2228
SP01068;SP;951;3742;2791;2367
SP01069;SP;660;3158;2498;2184
SP01070;SP;731;3112;2381;2017
SP01071;SP;364;1661;1297;1142
SP01072;SP;236;1029;793;657
SP01073;SP;603;2744;2141;1865
SP01074;SP;302;1372;1070;862
SP01075;SP;327;1334;1007;844
SP01076;SP;701;3137;2436;2116
SP01077;SP;594;3176;2582;2292
SP01078;SP;3099;10615;7516;6404
SP01079;SP;2431;8588;6157;5169
SP01080;SP;1064;3811;2747;2336
SP01081;SP;1162;4604;3442;2917
SP01082;SP;927;2526;1599;1355
SP01083;SP;1026;3114;2088;1808
SP01084;SP;871;4187;3316;2810
SP01085;SP;826;3957;3131;2527
SP01086;SP;1043;4668;3625;3064
SP01087;SP;700;3331;2631;2223
SP01088;SP;166;889;723;623
SP01089;SP;1311;5551;4240;3578
SP01090;SP;1059;4652;3593;2985
SP01091;SP;677;3433;2756;2254
SP01092;SP;2048;5885;3837;3221
SP01093;SP;1752;5944;4192;3670
SP01094;SP;1491;4951;3460;3031
SP01095;SP;1700;5974;4274;3630
SP01096;SP;1250;4179;2929;2561
SP01097;SP;2237;7641;5404;4710
SP01098;SP;1626;5642;4016;3546
SP01099;SP;1301;4340;3039;2637
SP01100;SP;1271;4090;2819;2441
SP01101;SP;1570;5144;3574;3122
SP01102;SP;1032;3065;2033;1773
SP01103;SP;1463;5564;4101;3623
SP01104;SP;1123;3373;2250;1905
SP01105;SP;1658;5682;4024;3544
SP01106;SP;2530;8626;6096;4992
SP01107;SP;2573;8910;6337;5296
SP01108;SP;796;3363;2567;2199
SP01109;SP;819;3179;2360;1954
SP01110;SP;962;3484;2522;2110
SP01111;SP;437;1699;1262;1087
SP01112;SP;463;1834;1371;1101
SP01113;SP;1233;5153;3920;3365
SP01114;SP;369;1783;1414;1235
SP01115;SP;426;2032;1606;1369
SP01116;SP;793;3795;3002;2684
SP01117;SP;196;703;507;424
SP01118;SP;922;3117;2195;1851
SP01119;SP;187;893;706;615
SP01120;SP;2057;6954;4897;4084
SP01121;SP;572;2241;1669;1388
SP01122;SP;1116;3123;2007;1679
SP01123;SP;2405;8211;5806;4970
SP01124;SP;2003;6479;4476;3780
SP01125;SP;959;3476;2517;2129
SP01126;SP;1883;6161;4278;3664
SP01127;SP;2266;7942;5676;4893
SP01128;SP;1451;4920;3469;2978
SP01129;SP;1676;6181;4505;3834
SP01130;SP;1815;6066;4251;3689
SP01131;SP;1387;5996;4609;3959
SP01132;SP;1812;5881;4069;3481
SP01133;SP;1725;5893;4168;3571
SP01134;SP;1237;4563;3326;2843
SP01135;SP;1513;5468;3955;3382
SP01136;SP;1561;6560;4999;4267
SP01137;SP;288;1190;902;772
SP01138;SP;813;3414;2601;2219
SP01139;SP;692;2703;2011;1677
SP01140;SP;1073;4702;3629;3096
SP01141;SP;1660;6662;5002;4271
SP01142;SP;1157;5011;3854;3252
SP01143;SP;758;3097;2339;2010
SP01144;SP;705;3086;2381;2043
SP01145;SP;1240;5008;3768;3211
SP01146;SP;1088;4300;3212;2676
SP01147;SP;613;2332;1719;1447
SP01148;SP;626;2683;2057;1715
SP01149;SP;807;3540;2733;2341
SP01150;SP;428;1851;1423;1168
SP01151;SP;162;692;530;435
SP01152;SP;267;1143;876;745
SP01153;SP;3346;12021;8675;7258
SP01154;SP;1776;7187;5411;4524
SP01155;SP;1122;4827;3705;3096
SP01156;SP;1150;4593;3443;2878
SP01157;SP;1713;6773;5060;4280
SP01158;SP;1659;6016;4357;3658
SP01159;SP;649;2758;2109;1753
SP01160;SP;419;1821;1402;1139
SP01161;SP;581;2722;2141;1793
SP01162;SP;315;1286;971;836
SP01163;SP;1326;4114;2788;2400
SP01164;SP;1820;5708;3888;3284
SP01165;SP;1112;3908;2796;2440
SP01166;SP;1519;5277;3758;3179
SP01167;SP;1809;6259;4450;3620
SP01168;SP;1822;5911;4089;3473
SP01169;SP;1826;6535;4709;3984
SP01170;SP;2257;7817;5560;4585
SP01171;SP;1861;6620;4759;3966
SP01172;SP;1801;6690;4889;4302
SP01173;SP;1222;4537;3315;2833
SP01174;SP;1916;6350;4434;3606
SP01175;SP;1251;4660;3409;2858
SP01176;SP;2485;8236;5751;4720
SP01177;SP;1235;4264;3029;2602
SP01178;SP;2131;7018;4887;4032
SP01179;SP;825;3692;2867;2431
SP01180;SP;1294;4666;3372;2690
SP01181;SP;1289;4741;3452;2824
SP01182;SP;1514;5929;4415;3910
SP01183;SP;1718;6376;4658;4013
SP01184;SP;1062;4359;3297;2764
SP01185;SP;929;3511;2582;2032
SP01186;SP;785;3559;2774;2416
SP01187;SP;633;2356;1723;1366
SP01188;SP;434;1590;1156;950
SP01189;SP;1871;5883;4012;3366
SP01190;SP;1538;5137;3599;3067
SP01191;SP;2054;7205;5151;4314
SP01192;SP;1508;5481;3973;3323
SP01193;SP;2025;6918;4893;4015
SP01194;SP;845;3150;2305;1880
SP01195;SP;1620;5991;4371;3710
SP01196;SP;1815;6441;4626;3945
SP01197;SP;1539;6065;4526;3795
SP01198;SP;994;4394;3400;2835
SP01199;SP;1132;4561;3429;2819
SP01200;SP;1272;4925;3653;2996
SP01201;SP;1460;5937;4477;3616
SP01202;SP;1623;6413;4790;3995
SP01203;SP;1188;5224;4036;3388
SP01204;SP;1268;5365;4097;3436
SP01205;SP;1598;6483;4885;4000
SP01206;SP;1164;4510;3346;2819
SP01207;SP;1055;4349;3294;2669
SP01208;SP;1660;6891;5231;4256
SP01209;SP;2061;7838;5777;4668
SP01210;SP;722;3150;2428;1963
SP01211;SP;1111;4601;3490;2769
SP01212;SP;1771;7434;5663;4627
SP01213;SP;1084;4450;3366;2741
SP01214;SP;1400;5318;3918;3148
SP01215;SP;1612;6563;4951;3868
SP01216;SP;1096;4894;3798;2945
SP01217;SP;566;2233;1667;1283
SP01218;SP;272;1256;984;793
SP01219;SP;874;3597;2723;2163
SP01220;SP;543;2623;2080;1725
SP01221;SP;1148;4891;3743;3051
SP01222;SP;458;2122;1664;1336
SP01223;SP;1129;3886;2757;2228
SP01224;SP;645;2283;1638;1302
SP01225;SP;100;458;358;286
SP01226;SP;238;959;721;572
SP01227;SP;1106;4013;2907;2421
SP01228;SP;1199;4077;2878;2288
SP01229;SP;1299;5709;4410;3576
SP01230;SP;759;2563;1804;1469
SP01231;SP;1512;4357;2845;2387
SP01232;SP;1364;4544;3180;2674
SP01233;SP;974;3348;2374;1949
SP01234;SP;482;1567;1085;923
SP01235;SP;2121;7584;5463;4460
SP01236;SP;1311;4335;3024;2493
SP01237;SP;1765;5922;4157;3352
SP01238;SP;1074;4275;3201;2644
SP01239;SP;1417;6020;4603;3712
SP01240;SP;490;2099;1609;1314
SP01241;SP;1719;6681;4962;3929
SP01242;SP;864;3576;2712;2164
SP01243;SP;1106;4912;3806;3153
SP01244;SP;795;3449;2654;2184
SP01245;SP;1801;7927;6126;5200
SP01246;SP;1463;6332;4869;4069
SP01247;SP;1135;4854;3719;3036
SP01248;SP;1581;6322;4741;3875
SP01249;SP;2221;7808;5587;4469
SP01250;SP;1045;4254;3209;2667
SP01251;SP;1497;5249;3752;3003
SP01252;SP;923;3905;2982;2358
SP01253;SP;375;1578;1203;980
SP01254;SP;1839;7148;5309;4294
SP01255;SP;1338;5145;3807;3011
SP01256;SP;1732;6264;4532;3688
SP01257;SP;809;3540;2731;2179
SP01258;SP;942;3588;2646;2112
SP01259;SP;433;1800;1367;1129
SP01260;SP;1485;5635;4150;3295
SP01261;SP;1067;4017;2950;2362
SP01262;SP;1044;4424;3380;2706
SP01263;SP;1336;3672;2336;1856
SP01264;SP;408;1742;1334;1046
SP01265;SP;670;2308;1638;1298
SP01266;SP;673;2296;1623;1294
SP01267;SP;994;3668;2674;2188
SP01268;SP;367;1395;1028;797
SP01269;SP;300;1317;1017;816
SP01270;SP;186;767;581;483
SP01271;SP;1177;3998;2821;2451
SP01272;SP;898;3598;2700;2308
SP01273;SP;1995;6832;4837;4051
SP01274;SP;1938;6482;4544;3933
SP01275;SP;2370;8215;5845;4919
SP01276;SP;1569;5814;4245;3567
SP01277;SP;1271;5451;4180;3551
SP01278;SP;1798;6124;4326;3583
SP01279;SP;1811;7160;5349;4413
SP01280;SP;1383;5845;4462;3757
SP01281;SP;1351;6196;4845;4089
SP01282;SP;2140;8652;6512;5430
SP01283;SP;978;4641;3663;3179
SP01284;SP;661;2886;2225;1912
SP01285;SP;1032;4343;3311;2805
SP01286;SP;1144;5329;4185;3573
SP01287;SP;1031;4630;3599;3061
SP01288;SP;841;3628;2787;2393
SP01289;SP;1925;8261;6336;5214
SP01290;SP;1366;5911;4545;3870
SP01291;SP;462;2147;1685;1455
SP01292;SP;1403;5775;4372;3718
SP01293;SP;1924;8374;6450;5532
SP01294;SP;1152;5309;4157;3488
SP01295;SP;670;3038;2368;2000
SP01296;SP;474;1918;1444;1219
SP01297;SP;1084;5073;3989;3288
SP01298;SP;1112;4397;3285;2749
SP01299;SP;893;3911;3018;2565
SP01300;SP;753;3153;2400;2048
SP01301;SP;470;2227;1757;1464
SP01302;SP;629;2717;2088;1784
SP01303;SP;1032;4518;3486;2977
SP01304;SP;964;3849;2885;2389
SP01305;SP;956;3647;2691;2223
SP01306;SP;2527;10069;7542;6154
SP01307;SP;1204;5091;3887;3217
SP01308;SP;986;4137;3151;2579
SP01309;SP;710;3292;2582;2150
SP01310;SP;1295;5036;3741;3075
SP01311;SP;56;289;233;207
SP01312;SP;1230;4582;3352;2711
SP01313;SP;1284;5646;4362;3544
SP01314;SP;1376;4826;3450;2922
SP01315;SP;1726;5836;4110;3568
SP01316;SP;2133;6703;4570;3887
SP01317;SP;2266;7496;5230;4360
SP01318;SP;1812;5897;4085;3426
SP01319;SP;1955;6497;4542;3670
SP01320;SP;2190;8209;6019;5015
SP01321;SP;1210;5117;3907;3326
SP01322;SP;1451;6445;4994;4166
SP01323;SP;1663;6741;5078;4301
SP01324;SP;452;1575;1123;935
SP01325;SP;637;2946;2309;1970
SP01326;SP;1234;4913;3679;2940
SP01327;SP;1657;5676;4019;3252
SP01328;SP;1425;6187;4762;4004
SP01329;SP;892;3596;2704;2290
SP01330;SP;1633;7538;5905;5127
SP01331;SP;512;1932;1420;1196
SP01332;SP;1370;5043;3673;3047
SP01333;SP;2423;8821;6398;5220
SP01334;SP;1474;5470;3996;3334
SP01335;SP;1903;7407;5504;4414
SP01336;SP;1656;6381;4725;3753
SP01337;SP;1484;5929;4445;3629
SP01338;SP;2958;10511;7553;6278
SP01339;SP;1736;6726;4990;3954
SP01340;SP;1601;6735;5134;4118
SP01341;SP;749;3295;2546;2084
SP01342;SP;408;1975;1567;1312
SP01343;SP;527;2274;1747;1438
SP01344;SP;487;1994;1507;1250
SP01345;SP;811;3443;2632;2198
SP01346;SP;1065;4333;3268;2784
SP01347;SP;1972;7950;5978;5066
SP01348;SP;1015;3369;2354;1888
SP01349;SP;1957;7723;5766;4646
SP01350;SP;2464;8729;6265;5053
SP01351;SP;383;1693;1310;1037
SP01352;SP;2563;9339;6776;5651
SP01353;SP;950;3717;2767;2349
SP01354;SP;1883;7702;5819;4593
SP01355;SP;428;1496;1068;855
SP01356;SP;293;1180;887;731
SP01357;SP;594;2333;1739;1398
SP01358;SP;317;931;614;523
SP01359;SP;266;839;573;457
SP01360;SP;1372;4177;2805;2337
SP01361;SP;2306;7818;5512;4598
SP01362;SP;2279;7767;5488;4591
SP01363;SP;1698;5696;3998;3277
SP01364;SP;873;3423;2550;2100
SP01365;SP;1296;4472;3176;2649
SP01366;SP;1845;6944;5099;4243
SP01367;SP;1303;4323;3020;2537
SP01368;SP;1591;6668;5077;4150
SP01369;SP;751;3307;2556;2150
SP01370;SP;1541;6243;4702;3926
SP01371;SP;2044;7808;5764;4744
SP01372;SP;663;2774;2111;1744
SP01373;SP;1783;6512;4729;3906
SP01374;SP;753;3027;2274;1892
SP01375;SP;1004;4586;3582;2958
SP01376;SP;644;2812;2168;1801
SP01377;SP;1833;6246;4413;3586
SP01378;SP;1325;5134;3809;3086
SP01379;SP;505;1511;1006;829
SP01380;SP;1646;6398;4752;3983
SP01381;SP;1389;5235;3846;3111
SP01382;SP;1262;4773;3511;2832
SP01383;SP;976;3644;2668;2188
SP01384;SP;359;1615;1256;1024
SP01385;SP;741;2603;1862;1531
SP01386;SP;1442;5463;4021;3254
SP01387;SP;731;3279;2548;2113
SP01388;SP;1067;4349;3282;2705
SP01389;SP;1598;5537;3939;3325
SP01390;SP;1467;5471;4004;3342
SP01391;SP;1427;5920;4493;3657
SP01392;SP;1260;5417;4157;3419
SP01393;SP;1247;4576;3329;2824
SP01394;SP;719;3196;2477;2018
SP01395;SP;1714;5978;4264;3711
SP01396;SP;1780;6178;4398;3609
SP01397;SP;2555;8800;6245;5280
SP01398;SP;1300;4499;3199;2780
SP01399;SP;2424;8543;6119;5176
SP01400;SP;1523;5413;3890;3387
SP01401;SP;2666;8695;6029;5349
SP01402;SP;1750;5706;3956;3495
SP01403;SP;1552;4451;2899;2519
SP01404;SP;1810;6132;4322;3778
SP01405;SP;1520;6097;4577;4036
SP01406;SP;1284;4561;3277;2840
SP01407;SP;1777;5751;3974;3419
SP01408;SP;1053;3519;2466;2143
SP01409;SP;1509;4997;3488;3043
SP01410;SP;1697;6568;4871;4389
SP01411;SP;1205;5127;3922;3438
SP01412;SP;1617;6509;4892;4139
SP01413;SP;1692;5838;4146;3467
SP01414;SP;2992;11881;8889;7501
SP01415;SP;1355;5045;3690;3218
SP01416;SP;874;3507;2633;2204
SP01417;SP;2177;8205;6028;5141
SP01418;SP;952;3824;2872;2479
SP01419;SP;845;3045;2200;1912
SP01420;SP;908;3530;2622;2168
SP01421;SP;2635;9984;7349;6353
SP01422;SP;895;3948;3053;2612
SP01423;SP;687;3120;2433;2133
SP01424;SP;552;2544;1992;1718
SP01425;SP;849;3763;2914;2538
SP01426;SP;1021;4324;3303;2818
SP01427;SP;4137;13842;9705;8556
SP01428;SP;232;957;725;645
SP01429;SP;1869;6808;4939;4206
SP01430;SP;778;2960;2182;1879
SP01431;SP;366;1550;1184;1036
SP01432;SP;612;2374;1762;1521
SP01433;SP;444;2066;1622;1356
SP01434;SP;290;1266;976;853
SP01435;SP;420;1570;1150;964
SP01436;SP;1167;3934;2767;2402
SP01437;SP;1326;5207;3881;3148
SP01438;SP;2005;7108;5103;4345
SP01439;SP;1271;4463;3192;2737
SP01440;SP;1392;4739;3347;2705
SP01441;SP;2035;6375;4340;3561
SP01442;SP;1271;5335;4064;3369
SP01443;SP;1457;6125;4668;3875
SP01444;SP;1152;5456;4304;3559
SP01445;SP;1317;5567;4250;3503
SP01446;SP;1124;4917;3793;3157
SP01447;SP;1016;4389;3373;2834
SP01448;SP;639;2723;2084;1723
SP01449;SP;1027;4414;3387;2785
SP01450;SP;1426;5727;4301;3610
SP01451;SP;1092;4196;3104;2494
SP01452;SP;1383;5785;4402;3633
SP01453;SP;1700;6778;5078;4140
SP01454;SP;972;4757;3785;3186
SP01455;SP;1223;5140;3917;3284
SP01456;SP;1268;5392;4124;3409
SP01457;SP;1248;4727;3479;2704
SP01458;SP;1031;4088;3057;2579
SP01459;SP;1119;4391;3272;2705
SP01460;SP;751;3158;2407;1981
SP01461;SP;1686;6903;5217;4301
SP01462;SP;1842;7003;5161;4135
SP01463;SP;1176;4734;3558;2951
SP01464;SP;1087;4055;2968;2449
SP01465;SP;955;3773;2818;2190
SP01466;SP;1291;5214;3923;3163
SP01467;SP;767;3037;2270;1875
SP01468;SP;759;3098;2339;1922
SP01469;SP;1344;5075;3731;2913
SP01470;SP;906;3423;2517;2119
SP01471;SP;405;1901;1496;1225
SP01472;SP;909;3226;2317;1968
SP01473;SP;1848;5784;3936;3286
SP01474;SP;2102;7185;5083;4320
SP01475;SP;1209;3961;2752;2310
SP01476;SP;1266;4315;3049;2546
SP01477;SP;1926;6382;4456;3738
SP01478;SP;2544;7765;5221;4345
SP01479;SP;1658;7013;5355;4424
SP01480;SP;2092;6794;4702;3955
SP01481;SP;788;2868;2080;1681
SP01482;SP;1699;6480;4781;3882
SP01483;SP;1426;5423;3997;3341
SP01484;SP;1166;4803;3637;3023
SP01485;SP;1058;4366;3308;2767
SP01486;SP;1537;6492;4955;4168
SP01487;SP;1205;5209;4004;3388
SP01488;SP;1048;4853;3805;3190
SP01489;SP;2086;7577;5491;4714
SP01490;SP;1164;5134;3970;3327
SP01491;SP;1389;4927;3538;2917
SP01492;SP;1899;6727;4828;4030
SP01493;SP;1010;3722;2712;2272
SP01494;SP;1900;6825;4925;4104
SP01495;SP;1369;5651;4282;3551
SP01496;SP;1351;5781;4430;3721
SP01497;SP;1389;5264;3875;3261
SP01498;SP;1465;5725;4260;3481
SP01499;SP;586;2259;1673;1371
SP01500;SP;368;1399;1031;873
SP01501;SP;222;923;701;595
SP01502;SP;995;4069;3074;2489
SP01503;SP;1533;5963;4430;3628
SP01504;SP;1104;3973;2869;2402
SP01505;SP;282;1275;993;808
SP01506;SP;973;3179;2206;1905
SP01507;SP;543;2166;1623;1390
SP01508;SP;600;2503;1903;1596
SP01509;SP;563;2116;1553;1253
SP01510;SP;508;2124;1616;1309
SP01511;SP;302;1342;1040;869
SP01512;SP;369;1736;1367;1142
SP01513;SP;1054;3487;2433;2006
SP01514;SP;374;980;606;480
SP01515;SP;73;216;143;108
SP01516;SP;100;273;173;136
SP01517;SP;2102;8843;6741;5697
SP01518;SP;1575;6543;4968;4096
SP01519;SP;868;3483;2615;2225
SP01520;SP;1180;4453;3273;2709
SP01521;SP;1662;6526;4864;4159
SP01522;SP;590;2437;1847;1570
SP01523;SP;1481;6929;5448;4659
SP01524;SP;1621;6877;5256;4395
SP01525;SP;1787;5422;3635;2997
SP01526;SP;1321;5784;4463;3807
SP01527;SP;1434;5330;3896;3210
SP01528;SP;753;3192;2439;2080
SP01529;SP;1985;8092;6107;5030
SP01530;SP;1050;4997;3947;3258
SP01531;SP;543;2226;1683;1420
SP01532;SP;1950;6761;4811;3976
SP01533;SP;1876;7786;5910;5039
SP01534;SP;1050;4049;2999;2548
SP01535;SP;1185;4410;3225;2671
SP01536;SP;1561;6545;4984;4185
SP01537;SP;1372;6049;4677;3878
SP01538;SP;1068;4587;3519;2931
SP01539;SP;590;2252;1662;1375
SP01540;SP;775;3159;2384;1968
SP01541;SP;886;3438;2552;2057
SP01542;SP;345;1396;1051;861
SP01543;SP;1672;6952;5280;4396
SP01544;SP;1115;4162;3047;2596
SP01545;SP;864;3463;2599;2199
SP01546;SP;1106;4679;3573;3012
SP01547;SP;767;2943;2176;1791
SP01548;SP;1276;5863;4587;3782
SP01549;SP;1108;4270;3162;2619
SP01550;SP;267;1274;1007;818
SP01551;SP;962;3659;2697;2171
SP01552;SP;989;3370;2381;1888
SP01553;SP;1466;5645;4179;3447
SP01554;SP;1441;5840;4399;3656
SP01555;SP;859;3529;2670;2199
SP01556;SP;686;2397;1711;1386
SP01557;SP;948;2937;1989;1611
SP01558;SP;1187;4788;3601;2955
SP01559;SP;295;1425;1130;925
SP01560;SP;446;1433;987;806
SP01561;SP;319;1622;1303;1060
SP01562;SP;375;1550;1175;980
SP01563;SP;526;1842;1316;1056
SP01564;SP;325;1289;964;782
SP01565;SP;259;1058;799;665
SP01566;SP;745;2212;1467;1174
SP01567;SP;156;425;269;226
SP01568;SP;171;443;272;217
SP01569;SP;167;570;403;336
SP01570;SP;11;80;69;55
SP01571;SP;13;115;102;85
SP01572;SP;26;253;227;192
SP01573;SP;17;70;53;45
SP01574;SP;2370;7876;5506;4641
SP01575;SP;1274;4037;2763;2347
SP01576;SP;1034;4532;3498;2944
SP01577;SP;1023;4405;3382;2871
SP01578;SP;1120;5035;3915;3263
SP01579;SP;811;3634;2823;2348
SP01580;SP;3932;12295;8363;6990
SP01581;SP;1496;5066;3570;3039
SP01582;SP;1386;5360;3974;3379
SP01583;SP;1336;5432;4096;3442
SP01584;SP;976;4414;3438;2829
SP01585;SP;1395;5347;3952;3209
SP01586;SP;1055;4583;3528;3021
SP01587;SP;581;2480;1899;1615
SP01588;SP;1015;4161;3146;2747
SP01589;SP;1138;5101;3963;3337
SP01590;SP;650;2697;2047;1741
SP01591;SP;1048;5257;4209;3614
SP01592;SP;1561;5927;4366;3664
SP01593;SP;899;3907;3008;2558
SP01594;SP;710;3504;2794;2366
SP01595;SP;766;3343;2577;2170
SP01596;SP;746;3064;2318;1886
SP01597;SP;655;2735;2080;1731
SP01598;SP;645;2456;1811;1493
SP01599;SP;1148;4566;3418;2825
SP01600;SP;467;2074;1607;1330
SP01601;SP;241;1244;1003;850
SP01602;SP;1307;5026;3719;3000
SP01603;SP;788;3140;2352;1886
SP01604;SP;573;2213;1640;1350
SP01605;SP;545;2247;1702;1425
SP01606;SP;1133;3909;2776;2270
SP01607;SP;250;1156;906;769
SP01608;SP;581;2455;1874;1552
SP01609;SP;1255;4359;3104;2531
SP01610;SP;784;3105;2321;1935
SP01611;SP;365;1491;1126;959
SP01612;SP;1388;5316;3928;3419
SP01613;SP;1429;5274;3845;3229
SP01614;SP;1390;5270;3880;3345
SP01615;SP;425;1988;1563;1367
SP01616;SP;1298;5568;4270;3582
SP01617;SP;1705;6274;4569;3806
SP01618;SP;2041;8129;6088;4942
SP01619;SP;1822;6560;4738;3972
SP01620;SP;896;3851;2955;2529
SP01621;SP;1263;5101;3838;3203
SP01622;SP;1105;4052;2947;2495
SP01623;SP;1120;3923;2803;2393
SP01624;SP;2201;7719;5518;4630
SP01625;SP;1195;5942;4747;4037
SP01626;SP;536;2768;2232;1856
SP01627;SP;1594;4603;3009;2576
SP01628;SP;265;974;709;596
SP01629;SP;811;3617;2806;2389
SP01630;SP;417;1721;1304;1090
SP01631;SP;843;3548;2705;2284
SP01632;SP;1796;5894;4098;3431
SP01633;SP;1480;5184;3704;3122
SP01634;SP;364;1387;1023;842
SP01635;SP;1988;6200;4212;3548
SP01636;SP;923;4041;3118;2633
SP01637;SP;339;1545;1206;1011
SP01638;SP;694;2663;1969;1626
SP01639;SP;225;778;553;436
SP01640;SP;573;2145;1572;1333
SP01641;SP;1374;5788;4414;3629
SP01642;SP;672;2330;1658;1391
SP01643;SP;2011;6423;4412;3733
SP01644;SP;1423;6058;4635;3858
SP01645;SP;1277;4193;2916;2472
SP01646;SP;913;4342;3429;2817
SP01647;SP;782;3641;2859;2359
SP01648;SP;1328;5393;4065;3385
SP01649;SP;876;3698;2822;2374
SP01650;SP;318;1635;1317;1109
SP01651;SP;1626;6989;5363;4534
SP01652;SP;1530;5410;3880;3273
SP01653;SP;248;1349;1101;921
SP01654;SP;1317;4908;3591;3061
SP01655;SP;1114;3529;2415;2058
SP01656;SP;1750;5925;4175;3558
SP01657;SP;543;2210;1667;1362
SP01658;SP;1260;4665;3405;2870
SP01659;SP;1025;4975;3950;3337
SP01660;SP;393;1780;1387;1175
SP01661;SP;1356;4921;3565;3038
SP01662;SP;1593;5362;3769;3191
SP01663;SP;1483;4863;3380;2815
SP01664;SP;873;4100;3227;2743
SP01665;SP;885;2933;2048;1706
SP01666;SP;888;3664;2776;2237
SP01667;SP;269;1115;846;684
SP01668;SP;271;1231;960;794
SP01669;SP;302;1414;1112;919
SP01670;SP;523;2365;1842;1519
SP01671;SP;569;2362;1793;1520
SP01672;SP;1134;4183;3049;2483
SP01673;SP;379;1979;1600;1367
SP01674;SP;601;2328;1727;1429
SP01675;SP;1861;7296;5435;4628
SP01676;SP;1649;7202;5553;4501
SP01677;SP;1765;6587;4822;4008
SP01678;SP;1649;6291;4642;3951
SP01679;SP;1361;6584;5223;4406
SP01680;SP;1243;5598;4355;3657
SP01681;SP;1496;6345;4849;4083
SP01682;SP;938;3870;2932;2329
SP01683;SP;1143;4635;3492;2877
SP01684;SP;1207;4928;3721;3132
SP01685;SP;2004;7787;5783;4857
SP01686;SP;1892;7314;5422;4542
SP01687;SP;1112;5072;3960;3344
SP01688;SP;1393;5851;4458;3814
SP01689;SP;1126;4779;3653;2960
SP01690;SP;883;3916;3033;2511
SP01691;SP;1479;6176;4697;3802
SP01692;SP;1662;6368;4706;3971
SP01693;SP;1154;5042;3888;3140
SP01694;SP;1620;6468;4848;4112
SP01695;SP;615;2859;2244;1904
SP01696;SP;866;3501;2635;2139
SP01697;SP;1570;6299;4729;4049
SP01698;SP;814;4270;3456;2903
SP01699;SP;526;2649;2123;1787
SP01700;SP;704;3480;2776;2319
SP01701;SP;1399;5870;4471;3616
SP01702;SP;560;2682;2122;1782
SP01703;SP;504;2290;1786;1471
SP01704;SP;1129;4240;3111;2402
SP01705;SP;443;1680;1237;999
SP01706;SP;1830;6272;4442;3788
SP01707;SP;1597;5330;3733;3140
SP01708;SP;1145;4897;3752;3009
SP01709;SP;1097;5123;4026;3430
SP01710;SP;1247;4727;3480;2859
SP01711;SP;759;2862;2103;1740
SP01712;SP;781;3629;2848;2457
SP01713;SP;963;4285;3322;2877
SP01714;SP;1024;3989;2965;2432
SP01715;SP;1284;3987;2703;2302
SP01716;SP;830;3015;2185;1849
SP01717;SP;976;3491;2515;2185
SP01718;SP;1671;6133;4462;3746
SP01719;SP;1405;5072;3667;3138
SP01720;SP;1115;4886;3771;3270
SP01721;SP;782;3300;2518;2118
SP01722;SP;1009;4433;3424;2973
SP01723;SP;666;2776;2110;1723
SP01724;SP;1357;5829;4472;3791
SP01725;SP;1576;6477;4901;4149
SP01726;SP;1043;4123;3080;2542
SP01727;SP;1062;4196;3134;2630
SP01728;SP;733;3507;2774;2436
SP01729;SP;955;3858;2903;2392
SP01730;SP;380;1570;1190;978
SP01731;SP;475;1980;1505;1257
SP01732;SP;1215;5337;4122;3348
SP01733;SP;1384;4951;3567;2964
SP01734;SP;1065;4835;3770;3245
SP01735;SP;644;2431;1787;1502
SP01736;SP;591;2336;1745;1472
SP01737;SP;1501;4533;3032;2598
SP01738;SP;1810;6502;4692;3933
SP01739;SP;1219;4727;3508;2932
SP01740;SP;1260;5160;3900;3207
SP01741;SP;451;2084;1633;1382
SP01742;SP;547;2540;1993;1660
SP01743;SP;1059;4150;3091;2542
SP01744;SP;540;2443;1903;1614
SP01745;SP;1189;3806;2617;2071
SP01746;SP;302;1007;705;558
SP01747;SP;565;2073;1508;1224
SP01748;SP;822;3372;2550;2096
SP01749;SP;841;3518;2677;2231
SP01750;SP;351;1938;1587;1344
SP01751;SP;281;1150;869;700
SP01752;SP;1537;5109;3572;2956
SP01753;SP;1651;5888;4237;3550
SP01754;SP;1407;5351;3944;3266
SP01755;SP;1077;4747;3670;3180
SP01756;SP;1681;6967;5286;4434
SP01757;SP;1493;6189;4696;4013
SP01758;SP;964;4558;3594;3021
SP01759;SP;1210;4843;3633;3053
SP01760;SP;871;3464;2593;2106
SP01761;SP;1589;6449;4860;3968
SP01762;SP;578;1989;1411;1185
SP01763;SP;1450;6217;4767;4102
SP01764;SP;1152;5036;3884;3281
SP01765;SP;905;3450;2545;2124
SP01766;SP;527;2383;1856;1558
SP01767;SP;1570;5732;4162;3518
SP01768;SP;1533;5069;3536;2973
SP01769;SP;1359;4801;3442;2891
SP01770;SP;1697;6174;4477;3720
SP01771;SP;651;2820;2169;1788
SP01772;SP;1737;6424;4687;3846
SP01773;SP;1396;5046;3650;3134
SP01774;SP;754;3149;2395;1983
SP01775;SP;1319;5254;3935;3270
SP01776;SP;1293;5029;3736;3151
SP01777;SP;1116;4580;3464;2911
SP01778;SP;1395;5530;4135;3487
SP01779;SP;725;3173;2448;2056
SP01780;SP;1668;6187;4519;3758
SP01781;SP;945;3570;2625;2218
SP01782;SP;457;1588;1131;923
SP01783;SP;606;2547;1941;1657
SP01784;SP;1390;5548;4158;3356
SP01785;SP;1005;3906;2901;2313
SP01786;SP;1258;5053;3795;3160
SP01787;SP;638;2575;1937;1569
SP01788;SP;1256;4509;3253;2662
SP01789;SP;1575;5960;4385;3608
SP01790;SP;822;3198;2376;1957
SP01791;SP;1537;5115;3578;2944
SP01792;SP;1189;4050;2861;2330
SP01793;SP;1259;3967;2708;2244
SP01794;SP;231;774;543;450
SP01795;SP;815;3220;2405;2019
SP01796;SP;1795;5940;4145;3466
SP01797;SP;1992;6711;4719;3984
SP01798;SP;2025;7205;5180;4415
SP01799;SP;1862;7489;5627;4802
SP01800;SP;2403;8375;5972;5040
SP01801;SP;1173;4591;3418;2903
SP01802;SP;1172;4568;3396;2879
SP01803;SP;1574;6098;4524;3804
SP01804;SP;1623;6591;4968;4178
SP01805;SP;1432;5577;4145;3471
SP01806;SP;1015;4493;3478;2937
SP01807;SP;1153;4489;3336;2767
SP01808;SP;596;2234;1638;1322
SP01809;SP;1132;4775;3643;3094
SP01810;SP;731;2637;1906;1572
SP01811;SP;1702;6412;4710;3911
SP01812;SP;394;1538;1144;965
SP01813;SP;1288;5173;3885;3261
SP01814;SP;1145;4705;3560;2954
SP01815;SP;897;3249;2352;1909
SP01816;SP;779;3092;2313;1986
SP01817;SP;855;3029;2174;1836
SP01818;SP;235;967;732;585
SP01819;SP;1483;6180;4697;3886
SP01820;SP;2386;8046;5660;4881
SP01821;SP;2173;7786;5613;4703
SP01822;SP;1867;6815;4948;4153
SP01823;SP;2194;7272;5078;4264
SP01824;SP;1103;3725;2622;2239
SP01825;SP;1675;5132;3457;3002
SP01826;SP;1828;6250;4422;3846
SP01827;SP;1938;6711;4773;3991
SP01828;SP;2286;8402;6116;5090
SP01829;SP;1748;6875;5127;4366
SP01830;SP;1090;3740;2650;2266
SP01831;SP;767;3229;2462;2131
SP01832;SP;1643;6225;4582;3756
SP01833;SP;1661;6103;4442;3955
SP01834;SP;296;1138;842;764
SP01835;SP;1633;6616;4983;4177
SP01836;SP;1608;6148;4540;3783
SP01837;SP;772;3345;2573;2095
SP01838;SP;829;3079;2250;1986
SP01839;SP;891;3350;2459;2084
SP01840;SP;616;2311;1695;1434
SP01841;SP;349;1166;817;691
SP01842;SP;1229;5313;4084;3333
SP01843;SP;988;3612;2624;2167
SP01844;SP;1443;4512;3069;2698
SP01845;SP;1851;6584;4733;3854
SP01846;SP;738;3222;2484;1943
SP01847;SP;667;2974;2307;1836
SP01848;SP;675;2632;1957;1644
SP01849;SP;998;3121;2123;1729
SP01850;SP;1059;3510;2451;2217
SP01851;SP;223;982;759;639
SP01852;SP;967;3141;2174;1762
SP01853;SP;715;3021;2306;2050
SP01854;SP;1666;5482;3816;3154
SP01855;SP;1083;3678;2595;2177
SP01856;SP;218;1178;960;866
SP01857;SP;1403;4340;2937;2615
SP01858;SP;2826;8697;5871;5026
SP01859;SP;1849;6287;4438;3780
SP01860;SP;1889;6782;4893;4316
SP01861;SP;1674;5487;3813;3319
SP01862;SP;1366;5013;3647;3119
SP01863;SP;1630;5889;4259;3651
SP01864;SP;1226;4267;3041;2596
SP01865;SP;1395;4732;3337;2900
SP01866;SP;1481;4946;3465;3008
SP01867;SP;1304;5509;4205;3512
SP01868;SP;1018;4200;3182;2758
SP01869;SP;1423;5661;4238;3691
SP01870;SP;1034;4686;3652;3133
SP01871;SP;1817;7738;5921;5048
SP01872;SP;1778;7613;5835;5033
SP01873;SP;665;2770;2105;1871
SP01874;SP;674;2682;2008;1770
SP01875;SP;1202;5494;4292;3611
SP01876;SP;1112;4608;3496;3087
SP01877;SP;1406;5858;4452;3755
SP01878;SP;1387;4970;3583;2983
SP01879;SP;1325;5975;4650;3979
SP01880;SP;1264;4589;3325;2844
SP01881;SP;2037;7339;5302;4562
SP01882;SP;460;1632;1172;988
SP01883;SP;1315;5157;3842;3197
SP01884;SP;1898;7365;5467;4519
SP01885;SP;393;1800;1407;1174
SP01886;SP;353;1564;1211;1003
SP01887;SP;3487;11149;7662;6482
SP01888;SP;1553;5852;4299;3704
SP01889;SP;2014;7228;5214;4452
SP01890;SP;1522;5322;3800;3207
SP01891;SP;593;2651;2058;1758
SP01892;SP;2287;7589;5302;4472
SP01893;SP;2128;6981;4853;4154
SP01894;SP;1770;7264;5494;4613
SP01895;SP;1102;4468;3366;2872
SP01896;SP;1152;4681;3529;2874
SP01897;SP;845;3517;2672;2257
SP01898;SP;1088;4700;3612;2987
SP01899;SP;1332;6018;4686;4033
SP01900;SP;1158;4988;3830;3267
SP01901;SP;615;2685;2070;1730
SP01902;SP;1022;4700;3678;3083
SP01903;SP;1520;5816;4296;3620
SP01904;SP;2137;6994;4857;4189
SP01905;SP;950;3477;2527;2101
SP01906;SP;1130;4600;3470;2856
SP01907;SP;1200;5356;4156;3425
SP01908;SP;897;3792;2895;2401
SP01909;SP;652;2748;2096;1732
SP01910;SP;437;1968;1531;1262
SP01911;SP;483;1962;1479;1263
SP01912;SP;354;1369;1015;853
SP01913;SP;1208;4665;3457;2853
SP01914;SP;1573;5492;3919;3429
SP01915;SP;1130;3924;2794;2392
SP01916;SP;1864;6631;4767;4053
SP01917;SP;1347;4628;3281;2811
SP01918;SP;1704;5928;4224;3607
SP01919;SP;1618;5480;3862;3239
SP01920;SP;1670;5883;4213;3594
SP01921;SP;1617;5497;3880;3373
SP01922;SP;1219;4328;3109;2674
SP01923;SP;1385;4807;3422;3020
SP01924;SP;1427;5115;3688;3218
SP01925;SP;1389;5445;4056;3565
SP01926;SP;1712;6354;4642;4010
SP01927;SP;1851;6734;4883;4168
SP01928;SP;1372;4314;2942;2411
SP01929;SP;1637;6511;4874;4168
SP01930;SP;1295;4667;3372;2823
SP01931;SP;1366;5097;3731;3193
SP01932;SP;1712;6660;4948;3975
SP01933;SP;1288;4814;3526;2989
SP01934;SP;1913;7848;5935;4997
SP01935;SP;1730;6268;4538;3717
SP01936;SP;1945;7478;5533;4689
SP01937;SP;672;2730;2058;1763
SP01938;SP;1810;7268;5458;4494
SP01939;SP;1772;6689;4917;4007
SP01940;SP;1431;5477;4046;3289
SP01941;SP;1037;3638;2601;2147
SP01942;SP;886;2838;1952;1638
SP01943;SP;1135;3522;2387;1965
SP01944;SP;1268;4146;2878;2323
SP01945;SP;262;778;516;438
SP01946;SP;625;2503;1878;1619
SP01947;SP;397;1722;1325;1151
SP01948;SP;1126;4518;3392;2842
SP01949;SP;1128;4412;3284;2711
SP01950;SP;992;3678;2686;2085
SP01951;SP;776;2720;1944;1556
SP01952;SP;547;1981;1434;1274
SP01953;SP;547;1981;1434;1274
SP01954;SP;642;2478;1836;1560
SP01955;SP;371;1676;1305;1081
SP01956;SP;513;2217;1704;1444
SP01957;SP;1400;4354;2954;2548
SP01958;SP;1478;5003;3525;3046
SP01959;SP;1753;5593;3840;3364
SP01960;SP;1621;5568;3947;3431
SP01961;SP;1748;5779;4031;3463
SP01962;SP;2015;7108;5093;4362
SP01963;SP;1789;6175;4386;3833
SP01964;SP;1516;5289;3773;3360
SP01965;SP;1675;6052;4377;3858
SP01966;SP;1042;3725;2683;2393
SP01967;SP;1295;4971;3676;3320
SP01968;SP;1899;6332;4433;3881
SP01969;SP;1156;4540;3384;3029
SP01970;SP;1274;5176;3902;3434
SP01971;SP;1082;4710;3628;3134
SP01972;SP;1110;4287;3177;2711
SP01973;SP;1283;4606;3323;2903
SP01974;SP;1524;6477;4953;4205
SP01975;SP;694;3160;2466;2160
SP01976;SP;377;1818;1441;1274
SP01977;SP;806;3135;2329;2006
SP01978;SP;467;2051;1584;1332
SP01979;SP;704;3299;2595;2305
SP01980;SP;791;3089;2298;1947
SP01981;SP;874;3490;2616;2256
SP01982;SP;210;971;761;641
SP01983;SP;154;776;622;557
SP01984;SP;396;1613;1217;1072
SP01985;SP;223;977;754;634
SP01986;SP;1768;5859;4091;3489
SP01987;SP;1296;4784;3488;2971
SP01988;SP;1760;5876;4116;3522
SP01989;SP;1648;5992;4344;3718
SP01990;SP;1503;6386;4883;4034
SP01991;SP;1576;6762;5186;4448
SP01992;SP;1917;6492;4575;3943
SP01993;SP;1349;5680;4331;3584
SP01994;SP;1794;8040;6246;5147
SP01995;SP;1384;5916;4532;3685
SP01996;SP;865;4065;3200;2650
SP01997;SP;1678;6927;5249;4360
SP01998;SP;1610;6178;4568;3831
SP01999;SP;1573;6988;5415;4564
SP02000;SP;763;3014;2251;1774
SP02001;SP;739;3226;2487;1984
SP02002;SP;918;3675;2757;2297
SP02003;SP;365;1402;1037;834
SP02004;SP;1208;5152;3944;3206
SP02005;SP;1186;4698;3512;2845
SP02006;SP;664;2512;1848;1496
SP02007;SP;750;2999;2249;1808
SP02008;SP;515;2358;1843;1542
SP02009;SP;675;2652;1977;1586
SP02010;SP;454;1994;1540;1280
SP02011;SP;480;1844;1364;1118
SP02012;SP;271;1265;994;819
SP02013;SP;1733;5458;3725;3087
SP02014;SP;996;3660;2664;2271
SP02015;SP;1968;6390;4422;3666
SP02016;SP;1213;3949;2736;2336
SP02017;SP;1489;5843;4354;3669
SP02018;SP;1519;4910;3391;2745
SP02019;SP;1649;5428;3779;3119
SP02020;SP;1419;5169;3750;3142
SP02021;SP;1074;4916;3842;3229
SP02022;SP;650;2804;2154;1788
SP02023;SP;1727;6925;5198;4333
SP02024;SP;1649;5319;3670;3226
SP02025;SP;1364;4781;3417;3034
SP02026;SP;1848;6348;4500;3840
SP02027;SP;1651;5306;3655;3143
SP02028;SP;2249;7224;4975;4154
SP02029;SP;2086;6908;4822;4034
SP02030;SP;2188;7717;5529;4653
SP02031;SP;1612;5725;4113;3423
SP02032;SP;1658;4842;3184;2718
SP02033;SP;1990;7687;5697;4752
SP02034;SP;1685;6228;4543;3751
SP02035;SP;966;4577;3611;3053
SP02036;SP;897;3622;2725;2407
SP02037;SP;1011;3883;2872;2425
SP02038;SP;1370;5939;4569;3984
SP02039;SP;1688;6572;4884;4051
SP02040;SP;665;2652;1987;1680
SP02041;SP;462;2020;1558;1334
SP02042;SP;813;2852;2039;1796
SP02043;SP;402;1561;1159;991
SP02044;SP;350;1543;1193;1063
SP02045;SP;500;2296;1796;1511
SP02046;SP;424;1856;1432;1244
SP02047;SP;1232;5031;3799;3118
SP02048;SP;570;2701;2131;1742
SP02049;SP;540;2278;1738;1487
SP02050;SP;840;3558;2718;2303
SP02051;SP;1063;4627;3564;3165
SP02052;SP;1347;4927;3580;3044
SP02053;SP;912;3844;2932;2581
SP02054;SP;600;2287;1687;1387
SP02055;SP;355;1516;1161;979
SP02056;SP;739;3560;2821;2491
SP02057;SP;790;3114;2324;1921
SP02058;SP;1007;3951;2944;2403
SP02059;SP;17;112;95;73
SP02060;SP;57;285;228;186
SP02061;SP;120;234;114;88
SP02062;SP;38;117;79;72
