CD_LOC;UF;abstencoes;aptos;comparecimentos;validos
SP00001;SP;3412;10045;6633;6348
SP00002;SP;2937;8476;5539;5301
SP00003;SP;2661;6223;3562;3339
SP00004;SP;1954;6071;4117;3823
SP00005;SP;2723;7574;4851;4540
SP00006;SP;1991;6187;4196;3968
SP00007;SP;4021;9748;5727;5355
SP00008;SP;1540;4250;2710;2536
SP00009;SP;1933;5809;3876;3718
SP00010;SP;3230;9269;6039;5790
SP00011;SP;2573;7822;5249;4994
SP00012;SP;3325;9441;6116;5769
SP00013;SP;1311;4269;2958;2829
SP00014;SP;2720;7153;4433;4097
SP00015;SP;1690;4890;3200;2952
SP00016;SP;1851;4976;3125;2880
SP00017;SP;2707;6847;4140;3867
SP00018;SP;1982;5238;3256;3039
SP00019;SP;1252;4798;3546;3411
SP00020;SP;502;1562;1060;990
SP00021;SP;1170;3914;2744;2564
SP00022;SP;1616;5474;3858;3481
SP00023;SP;581;2029;1448;1349
SP00024;SP;175;629;454;432
SP00025;SP;966;3193;2227;2126
SP00026;SP;458;1515;1057;991
SP00027;SP;1078;3011;1933;1858
SP00028;SP;2895;8070;5175;4942
SP00029;SP;5198;17797;12599;12178
SP00030;SP;987;2911;1924;1835
SP00031;SP;2144;6412;4268;4024
SP00032;SP;3484;11991;8507;8299
SP00033;SP;2464;7735;5271;4985
SP00034;SP;2155;5401;3246;3075
SP00035;SP;1749;5608;3859;3597
SP00036;SP;1940;6716;4776;4617
SP00037;SP;1524;5446;3922;3788
SP00038;SP;2394;8044;5650;5390
SP00039;SP;2055;6391;4336;4105
SP00040;SP;1854;7288;5434;5235
SP00041;SP;1394;4585;3191;3059
SP00042;SP;876;3797;2921;2792
SP00043;SP;857;3049;2192;2077
SP00044;SP;2046;7789;5743;5545
SP00045;SP;845;3377;2532;2413
SP00046;SP;2114;8211;6097;5898
SP00047;SP;1324;4672;3348;3176
SP00048;SP;1248;5609;4361;4173
SP00049;SP;713;2731;2018;1963
SP00050;SP;513;1956;1443;1402
SP00051;SP;3595;9919;6324;6155
SP00052;SP;2032;5165;3133;2935
SP00053;SP;2413;6007;3594;3324
SP00054;SP;1943;5696;3753;3408
SP00055;SP;2835;8226;5391;4961
SP00056;SP;2154;5794;3640;3387
SP00057;SP;1616;4525;2909;2654
SP00058;SP;1839;5387;3548;3268
SP00059;SP;2032;6072;4040;3728
SP00060;SP;2054;6204;4150;3837
SP00061;SP;1697;5110;3413;3165
SP00062;SP;1415;4386;2971;2733
SP00063;SP;1144;2961;1817;1694
SP00064;SP;2171;6208;4037;3695
SP00065;SP;1378;3705;2327;2080
SP00066;SP;1015;2941;1926;1749
SP00067;SP;577;1499;922;822
SP00068;SP;22;86;64;48
SP00069;SP;907;2939;2032;1880
SP00070;SP;1224;4221;2997;2825
SP00071;SP;2465;6547;4082;3719
SP00072;SP;1759;4862;3103;2890
SP00073;SP;5054;14871;9817;9320
SP00074;SP;1539;4599;3060;2873
SP00075;SP;844;2374;1530;1409
SP00076;SP;2611;7781;5170;4791
SP00077;SP;1602;5316;3714;3401
SP00078;SP;1674;6145;4471;4230
SP00079;SP;1627;6753;5126;4740
SP00080;SP;14;57;43;41
SP00081;SP;1791;4985;3194;2956
SP00082;SP;699;2042;1343;1244
SP00083;SP;3412;12710;9298;8782
SP00084;SP;2554;8514;5960;5561
SP00085;SP;2420;7942;5522;5162
SP00086;SP;1781;5934;4153;3890
SP00087;SP;2124;7025;4901;4584
SP00088;SP;2444;8110;5666;5310
SP00089;SP;2032;6261;4229;4005
SP00090;SP;1710;5982;4272;4069
SP00091;SP;2120;6781;4661;4328
SP00092;SP;2336;8010;5674;5327
SP00093;SP;1114;4638;3524;3326
SP00094;SP;1033;3713;2680;2478
SP00095;SP;1884;7262;5378;4963
SP00096;SP;1116;3961;2845;2573
SP00097;SP;1160;4480;3320;2992
SP00098;SP;1337;5038;3701;3346
SP00099;SP;1206;4550;3344;3017
SP00100;SP;1297;4225;2928;2713
SP00101;SP;2177;8957;6780;6355
SP00102;SP;1888;4710;2822;2612
SP00103;SP;745;2478;1733;1615
SP00104;SP;7;23;16;13
SP00105;SP;1240;3570;2330;2269
SP00106;SP;1728;4729;3001;2887
SP00107;SP;1653;5091;3438;3330
SP00108;SP;2710;7706;4996;4834
SP00109;SP;1263;3531;2268;2183
SP00110;SP;1471;4331;2860;2746
SP00111;SP;1692;5405;3713;3600
SP00112;SP;1806;5370;3564;3414
SP00113;SP;1454;4368;2914;2813
SP00114;SP;4244;11524;7280;6980
SP00115;SP;2119;6789;4670;4459
SP00116;SP;4649;13458;8809;8500
SP00117;SP;4232;12258;8026;7754
SP00118;SP;4044;11540;7496;7234
SP00119;SP;3070;8699;5629;5431
SP00120;SP;2439;7492;5053;4864
SP00121;SP;1388;4046;2658;2521
SP00122;SP;690;2338;1648;1597
SP00123;SP;631;2390;1759;1701
SP00124;SP;1721;5471;3750;3559
SP00125;SP;2713;8768;6055;5776
SP00126;SP;1182;3970;2788;2688
SP00127;SP;2179;7300;5121;4900
SP00128;SP;3284;9830;6546;6200
SP00129;SP;2412;8021;5609;5363
SP00130;SP;2393;7718;5325;5106
SP00131;SP;1415;5037;3622;3474
SP00132;SP;1560;4938;3378;3204
SP00133;SP;1286;4191;2905;2762
SP00134;SP;1774;5615;3841;3657
SP00135;SP;3246;10099;6853;6392
SP00136;SP;2744;9241;6497;6114
SP00137;SP;2003;6956;4953;4699
SP00138;SP;985;3114;2129;2001
SP00139;SP;2431;7945;5514;5139
SP00140;SP;1904;5793;3889;3638
SP00141;SP;1408;4594;3186;2978
SP00142;SP;1551;4541;2990;2779
SP00143;SP;2415;8101;5686;5354
SP00144;SP;1825;5788;3963;3797
SP00145;SP;1101;4652;3551;3385
SP00146;SP;1932;7336;5404;5008
SP00147;SP;1789;7272;5483;5236
SP00148;SP;1279;4985;3706;3480
SP00149;SP;862;3452;2590;2382
SP00150;SP;578;2320;1742;1690
SP00151;SP;1300;4988;3688;3300
SP00152;SP;316;857;541;478
SP00153;SP;1798;6503;4705;4168
SP00154;SP;2077;6876;4799;4240
SP00155;SP;1823;6109;4286;3806
SP00156;SP;2211;7080;4869;4246
SP00157;SP;559;1487;928;830
SP00158;SP;1915;5902;3987;3548
SP00159;SP;2448;8207;5759;5166
SP00160;SP;1818;7072;5254;4610
SP00161;SP;2001;7454;5453;4797
SP00162;SP;2083;7705;5622;4963
SP00163;SP;1642;6612;4970;4425
SP00164;SP;1500;5864;4364;3867
SP00165;SP;1270;5151;3881;3428
SP00166;SP;935;3724;2789;2473
SP00167;SP;1645;6528;4883;4292
SP00168;SP;1154;4204;3050;2777
SP00169;SP;1609;6507;4898;4346
SP00170;SP;928;3660;2732;2432
SP00171;SP;1563;6293;4730;4154
SP00172;SP;1110;4627;3517;3151
SP00173;SP;440;1568;1128;1010
SP00174;SP;1050;4271;3221;2857
SP00175;SP;1305;4700;3395;2965
SP00176;SP;1195;4725;3530;3165
SP00177;SP;1671;6291;4620;4038
SP00178;SP;2189;8552;6363;5673
SP00179;SP;847;3023;2176;1912
SP00180;SP;723;2715;1992;1750
SP00181;SP;365;1188;823;726
SP00182;SP;222;780;558;495
SP00183;SP;436;1181;745;666
SP00184;SP;211;781;570;495
SP00185;SP;215;785;570;508
SP00186;SP;330;1134;804;715
SP00187;SP;237;792;555;482
SP00188;SP;1111;4302;3191;2827
SP00189;SP;1884;5717;3833;3560
SP00190;SP;2976;9191;6215;5844
SP00191;SP;1507;4893;3386;3249
SP00192;SP;1059;3326;2267;2144
SP00193;SP;1442;4453;3011;2835
SP00194;SP;2347;8615;6268;5988
SP00195;SP;1217;3523;2306;2147
SP00196;SP;923;3423;2500;2339
SP00197;SP;1489;4829;3340;3224
SP00198;SP;2789;9846;7057;6645
SP00199;SP;2654;9351;6697;6340
SP00200;SP;1339;4987;3648;3418
SP00201;SP;2887;9459;6572;6245
SP00202;SP;2504;7973;5469;5239
SP00203;SP;2168;7005;4837;4575
SP00204;SP;1040;4526;3486;3306
SP00205;SP;859;3126;2267;2206
SP00206;SP;797;3004;2207;2096
SP00207;SP;1099;4643;3544;3258
SP00208;SP;501;1780;1279;1212
SP00209;SP;1075;4117;3042;2916
SP00210;SP;559;2712;2153;1998
SP00211;SP;1706;6388;4682;4400
SP00212;SP;1462;5586;4124;3887
SP00213;SP;1278;4732;3454;3206
SP00214;SP;1482;5779;4297;3998
SP00215;SP;232;993;761;700
SP00216;SP;478;2036;1558;1461
SP00217;SP;322;1566;1244;1183
SP00218;SP;1008;3583;2575;2405
SP00219;SP;1607;5453;3846;3563
SP00220;SP;665;2119;1454;1338
SP00221;SP;975;3925;2950;2640
SP00222;SP;1593;5627;4034;3671
SP00223;SP;757;2666;1909;1738
SP00224;SP;1387;4682;3295;2987
SP00225;SP;1377;4793;3416;3011
SP00226;SP;1823;6504;4681;4140
SP00227;SP;1432;5078;3646;3199
SP00228;SP;1093;3772;2679;2329
SP00229;SP;1646;6362;4716;4121
SP00230;SP;1303;4442;3139;2770
SP00231;SP;992;4477;3485;3112
SP00232;SP;1658;6760;5102;4486
SP00233;SP;662;2180;1518;1359
SP00234;SP;294;1126;832;745
SP00235;SP;1626;6359;4733;4142
SP00236;SP;1082;4570;3488;3132
SP00237;SP;1175;4589;3414;3015
SP00238;SP;1341;6012;4671;4143
SP00239;SP;1353;5869;4516;3916
SP00240;SP;802;3251;2449;2187
SP00241;SP;885;3798;2913;2571
SP00242;SP;1014;4031;3017;2629
SP00243;SP;1182;3895;2713;2333
SP00244;SP;388;1594;1206;1050
SP00245;SP;402;1860;1458;1275
SP00246;SP;152;730;578;507
SP00247;SP;683;3039;2356;2046
SP00248;SP;800;2993;2193;1944
SP00249;SP;996;3623;2627;2362
SP00250;SP;898;4023;3125;2707
SP00251;SP;998;3854;2856;2545
SP00252;SP;1210;4288;3078;2678
SP00253;SP;1512;6617;5105;4447
SP00254;SP;1222;4716;3494;3128
SP00255;SP;1734;6778;5044;4539
SP00256;SP;971;4254;3283;2810
SP00257;SP;1475;5556;4081;3501
SP00258;SP;716;2237;1521;1287
SP00259;SP;404;1803;1399;1245
SP00260;SP;2081;6967;4886;4308
SP00261;SP;1744;5727;3983;3595
SP00262;SP;1953;6791;4838;4273
SP00263;SP;2712;10873;8161;7340
SP00264;SP;1849;6606;4757;4115
SP00265;SP;1459;5313;3854;3413
SP00266;SP;1861;6960;5099;4440
SP00267;SP;1780;6197;4417;3869
SP00268;SP;1915;6330;4415;3861
SP00269;SP;1250;4567;3317;2942
SP00270;SP;1617;6129;4512;3966
SP00271;SP;1827;6516;4689;4064
SP00272;SP;740;3513;2773;2455
SP00273;SP;1225;5615;4390;3838
SP00274;SP;1056;5083;4027;3557
SP00275;SP;964;4248;3284;2908
SP00276;SP;965;4234;3269;2855
SP00277;SP;1055;4274;3219;2827
SP00278;SP;990;3874;2884;2530
SP00279;SP;1002;3855;2853;2445
SP00280;SP;1638;6493;4855;4191
SP00281;SP;1462;5656;4194;3685
SP00282;SP;1622;6521;4899;4303
SP00283;SP;1055;4282;3227;2830
SP00284;SP;1147;4514;3367;2958
SP00285;SP;563;2333;1770;1605
SP00286;SP;1546;6009;4463;3922
SP00287;SP;448;1938;1490;1314
SP00288;SP;605;2503;1898;1633
SP00289;SP;864;3751;2887;2482
SP00290;SP;488;2127;1639;1462
SP00291;SP;12;43;31;28
SP00292;SP;1238;3524;2286;2155
SP00293;SP;889;2607;1718;1581
SP00294;SP;1498;5157;3659;3480
SP00295;SP;1607;4636;3029;2813
SP00296;SP;804;2387;1583;1489
SP00297;SP;365;1311;946;886
SP00298;SP;1357;4475;3118;2935
SP00299;SP;614;2182;1568;1433
SP00300;SP;1324;5119;3795;3534
SP00301;SP;879;3036;2157;2025
SP00302;SP;1325;5488;4163;3975
SP00303;SP;1133;3512;2379;2237
SP00304;SP;957;3481;2524;2382
SP00305;SP;1103;2904;1801;1686
SP00306;SP;1628;5275;3647;3390
SP00307;SP;1173;3529;2356;2144
SP00308;SP;1364;4601;3237;2869
SP00309;SP;1118;3845;2727;2512
SP00310;SP;1668;5928;4260;3880
SP00311;SP;1533;4745;3212;3053
SP00312;SP;954;3428;2474;2317
SP00313;SP;1443;5494;4051;3796
SP00314;SP;838;2699;1861;1714
SP00315;SP;1585;5861;4276;4036
SP00316;SP;2278;8808;6530;6165
SP00317;SP;541;2042;1501;1344
SP00318;SP;730;2552;1822;1681
SP00319;SP;591;2366;1775;1683
SP00320;SP;1369;4504;3135;2925
SP00321;SP;1255;4314;3059;2905
SP00322;SP;2710;8258;5548;5222
SP00323;SP;1337;4008;2671;2514
SP00324;SP;1451;4770;3319;3134
SP00325;SP;1192;4286;3094;2933
SP00326;SP;1184;3933;2749;2597
SP00327;SP;497;1859;1362;1249
SP00328;SP;1044;3718;2674;2416
SP00329;SP;1139;3347;2208;1978
SP00330;SP;1189;4062;2873;2687
SP00331;SP;845;3036;2191;2089
SP00332;SP;770;3054;2284;2189
SP00333;SP;698;2049;1351;1258
SP00334;SP;430;1713;1283;1196
SP00335;SP;1126;4066;2940;2643
SP00336;SP;942;3224;2282;2045
SP00337;SP;377;1495;1118;1019
SP00338;SP;1468;4592;3124;2890
SP00339;SP;1027;3299;2272;2133
SP00340;SP;1072;3747;2675;2535
SP00341;SP;881;3178;2297;2175
SP00342;SP;1461;5123;3662;3456
SP00343;SP;1483;5204;3721;3509
SP00344;SP;1731;5849;4118;3908
SP00345;SP;2470;7886;5416;5134
SP00346;SP;390;1595;1205;1140
SP00347;SP;822;3164;2342;2239
SP00348;SP;1278;4643;3365;3144
SP00349;SP;863;3642;2779;2498
SP00350;SP;317;1278;961;889
SP00351;SP;197;883;686;634
SP00352;SP;560;2374;1814;1735
SP00353;SP;705;2983;2278;2162
SP00354;SP;269;1134;865;774
SP00355;SP;422;1892;1470;1380
SP00356;SP;1681;6871;5190;4952
SP00357;SP;12;35;23;16
SP00358;SP;14;39;25;17
SP00359;SP;10;40;30;26
SP00360;SP;13;119;106;81
SP00361;SP;8;20;12;11
SP00362;SP;547;1767;1220;1161
SP00363;SP;2252;6587;4335;4159
SP00364;SP;646;1999;1353;1290
SP00365;SP;2077;5757;3680;3594
SP00366;SP;1688;5574;3886;3762
SP00367;SP;1138;3181;2043;1955
SP00368;SP;1396;4441;3045;2913
SP00369;SP;1247;4203;2956;2893
SP00370;SP;2002;7693;5691;5525
SP00371;SP;2241;7513;5272;5094
SP00372;SP;1902;5891;3989;3869
SP00373;SP;1632;5182;3550;3450
SP00374;SP;1341;4011;2670;2595
SP00375;SP;1404;4721;3317;3209
SP00376;SP;1451;4805;3354;3222
SP00377;SP;1166;4059;2893;2778
SP00378;SP;1095;3829;2734;2639
SP00379;SP;1364;4356;2992;2840
SP00380;SP;1413;4357;2944;2844
SP00381;SP;1388;4728;3340;3209
SP00382;SP;600;1970;1370;1324
SP00383;SP;1207;3490;2283;2193
SP00384;SP;798;2769;1971;1918
SP00385;SP;1130;3955;2825;2691
SP00386;SP;462;2170;1708;1657
SP00387;SP;733;3215;2482;2390
SP00388;SP;502;1990;1488;1432
SP00389;SP;721;2663;1942;1851
SP00390;SP;1179;4307;3128;2859
SP00391;SP;1102;3539;2437;2238
SP00392;SP;1290;4859;3569;3317
SP00393;SP;1149;3958;2809;2551
SP00394;SP;798;2651;1853;1719
SP00395;SP;2283;7319;5036;4565
SP00396;SP;966;2981;2015;1839
SP00397;SP;1178;4072;2894;2605
SP00398;SP;991;2787;1796;1594
SP00399;SP;1231;4200;2969;2734
SP00400;SP;650;2153;1503;1380
SP00401;SP;1789;6075;4286;3897
SP00402;SP;1138;4338;3200;2895
SP00403;SP;1906;6930;5024;4519
SP00404;SP;1488;5256;3768;3374
SP00405;SP;1165;4680;3515;3259
SP00406;SP;1108;3867;2759;2477
SP00407;SP;1156;4191;3035;2687
SP00408;SP;2088;7217;5129;4589
SP00409;SP;1391;5537;4146;3675
SP00410;SP;392;1624;1232;1111
SP00411;SP;411;1750;1339;1214
SP00412;SP;532;2247;1715;1566
SP00413;SP;1092;5079;3987;3568
SP00414;SP;512;2489;1977;1785
SP00415;SP;895;3888;2993;2755
SP00416;SP;393;1565;1172;1044
SP00417;SP;334;1590;1256;1153
SP00418;SP;372;1339;967;854
SP00419;SP;1477;4961;3484;3249
SP00420;SP;416;1442;1026;968
SP00421;SP;867;3048;2181;2036
SP00422;SP;2725;10320;7595;7125
SP00423;SP;1355;4513;3158;2954
SP00424;SP;1374;4823;3449;3189
SP00425;SP;1674;6519;4845;4576
SP00426;SP;1966;6948;4982;4659
SP00427;SP;1191;4605;3414;3208
SP00428;SP;1699;5397;3698;3482
SP00429;SP;1519;5111;3592;3374
SP00430;SP;2158;8129;5971;5673
SP00431;SP;1295;4417;3122;2899
SP00432;SP;1210;3964;2754;2526
SP00433;SP;1142;4353;3211;3018
SP00434;SP;1576;5194;3618;3310
SP00435;SP;1757;7037;5280;4887
SP00436;SP;878;2845;1967;1786
SP00437;SP;1343;4783;3440;3177
SP00438;SP;930;3263;2333;2118
SP00439;SP;995;3746;2751;2521
SP00440;SP;1207;4147;2940;2666
SP00441;SP;1406;4817;3411;3092
SP00442;SP;720;3055;2335;2172
SP00443;SP;1422;5342;3920;3682
SP00444;SP;1007;4038;3031;2821
SP00445;SP;461;2263;1802;1650
SP00446;SP;1547;7010;5463;5115
SP00447;SP;939;4015;3076;2828
SP00448;SP;514;2058;1544;1442
SP00449;SP;1495;6333;4838;4543
SP00450;SP;1055;4825;3770;3580
SP00451;SP;422;1835;1413;1321
SP00452;SP;806;3018;2212;2062
SP00453;SP;348;1256;908;812
SP00454;SP;1915;6000;4085;3686
SP00455;SP;1209;4145;2936;2760
SP00456;SP;1225;4320;3095;2847
SP00457;SP;876;2816;1940;1788
SP00458;SP;2559;8529;5970;5467
SP00459;SP;1204;4392;3188;2898
SP00460;SP;1795;6386;4591;4172
SP00461;SP;1143;4042;2899;2597
SP00462;SP;1518;5168;3650;3260
SP00463;SP;366;1010;644;588
SP00464;SP;1104;4296;3192;2788
SP00465;SP;2123;7597;5474;4914
SP00466;SP;1649;6038;4389;3941
SP00467;SP;1476;5303;3827;3456
SP00468;SP;1476;5330;3854;3532
SP00469;SP;1594;5448;3854;3537
SP00470;SP;1427;4692;3265;3015
SP00471;SP;1018;3265;2247;2066
SP00472;SP;701;2507;1806;1635
SP00473;SP;1481;5477;3996;3679
SP00474;SP;1532;5075;3543;3281
SP00475;SP;1730;5821;4091;3761
SP00476;SP;1664;5975;4311;3973
SP00477;SP;860;2863;2003;1826
SP00478;SP;1001;3496;2495;2279
SP00479;SP;691;2742;2051;1879
SP00480;SP;523;1874;1351;1233
SP00481;SP;384;1516;1132;1030
SP00482;SP;1768;6633;4865;4487
SP00483;SP;656;2523;1867;1700
SP00484;SP;828;3212;2384;2210
SP00485;SP;395;1466;1071;1005
SP00486;SP;1108;4286;3178;2834
SP00487;SP;521;2063;1542;1356
SP00488;SP;418;1859;1441;1316
SP00489;SP;299;1525;1226;1114
SP00490;SP;653;1981;1328;1190
SP00491;SP;221;985;764;713
SP00492;SP;176;847;671;610
SP00493;SP;310;1172;862;776
SP00494;SP;22;54;32;29
SP00495;SP;14;54;40;37
SP00496;SP;1207;4579;3372;3164
SP00497;SP;1990;6925;4935;4614
SP00498;SP;947;3111;2164;1973
SP00499;SP;1930;6834;4904;4505
SP00500;SP;1850;6586;4736;4227
SP00501;SP;1436;4776;3340;3012
SP00502;SP;1898;6808;4910;4479
SP00503;SP;1985;6619;4634;4261
SP00504;SP;963;4008;3045;2772
SP00505;SP;653;2185;1532;1412
SP00506;SP;1254;4319;3065;2767
SP00507;SP;2618;9953;7335;6671
SP00508;SP;1490;5317;3827;3455
SP00509;SP;1394;4399;3005;2720
SP00510;SP;1880;6209;4329;3841
SP00511;SP;2064;6942;4878;4337
SP00512;SP;2226;7389;5163;4594
SP00513;SP;1113;4106;2993;2725
SP00514;SP;1524;5514;3990;3648
SP00515;SP;1248;4792;3544;3225
SP00516;SP;2061;6938;4877;4364
SP00517;SP;1044;3694;2650;2378
SP00518;SP;1477;4780;3303;3021
SP00519;SP;1725;5846;4121;3726
SP00520;SP;880;3065;2185;1962
SP00521;SP;1512;5002;3490;3052
SP00522;SP;1176;4695;3519;3108
SP00523;SP;1061;4290;3229;2820
SP00524;SP;715;2811;2096;1907
SP00525;SP;1400;5945;4545;4073
SP00526;SP;817;3210;2393;2124
SP00527;SP;630;3105;2475;2265
SP00528;SP;589;2366;1777;1669
SP00529;SP;786;3155;2369;2189
SP00530;SP;357;1521;1164;1056
SP00531;SP;1705;6972;5267;4741
SP00532;SP;735;2674;1939;1774
SP00533;SP;557;2644;2087;1916
SP00534;SP;942;4351;3409;3196
SP00535;SP;1569;4936;3367;3157
SP00536;SP;1749;6329;4580;4200
SP00537;SP;1313;4344;3031;2817
SP00538;SP;1666;5278;3612;3264
SP00539;SP;1836;5948;4112;3885
SP00540;SP;1083;3175;2092;1924
SP00541;SP;1083;3175;2092;1924
SP00542;SP;1451;4842;3391;3009
SP00543;SP;2618;8077;5459;4828
SP00544;SP;1829;5536;3707;3426
SP00545;SP;2233;7097;4864;4426
SP00546;SP;1495;4580;3085;2734
SP00547;SP;916;3238;2322;2126
SP00548;SP;1450;4404;2954;2736
SP00549;SP;1918;5928;4010;3711
SP00550;SP;1329;4742;3413;3090
SP00551;SP;1327;4597;3270;2992
SP00552;SP;1909;5887;3978;3593
SP00553;SP;1552;4676;3124;2777
SP00554;SP;1397;5499;4102;3539
SP00555;SP;978;3492;2514;2217
SP00556;SP;469;1967;1498;1364
SP00557;SP;1586;5966;4380;3869
SP00558;SP;1433;5547;4114;3583
SP00559;SP;1748;6869;5121;4487
SP00560;SP;1312;4755;3443;3032
SP00561;SP;1212;4720;3508;3096
SP00562;SP;817;3269;2452;2249
SP00563;SP;1024;3945;2921;2552
SP00564;SP;1630;6019;4389;3798
SP00565;SP;792;3148;2356;2159
SP00566;SP;972;3965;2993;2667
SP00567;SP;1099;3964;2865;2677
SP00568;SP;1167;4355;3188;3011
SP00569;SP;640;2316;1676;1494
SP00570;SP;371;1547;1176;1032
SP00571;SP;496;1966;1470;1274
SP00572;SP;1425;5117;3692;3220
SP00573;SP;300;1187;887;778
SP00574;SP;1552;4916;3364;2915
SP00575;SP;606;1945;1339;1156
SP00576;SP;0;45;45;43
SP00577;SP;2573;8415;5842;5470
SP00578;SP;711;2949;2238;2075
SP00579;SP;1251;4397;3146;2800
SP00580;SP;880;3133;2253;2085
SP00581;SP;1534;5307;3773;3511
SP00582;SP;1178;4259;3081;2839
SP00583;SP;1316;4985;3669;3376
SP00584;SP;760;2542;1782;1595
SP00585;SP;1428;4746;3318;3055
SP00586;SP;639;2592;1953;1811
SP00587;SP;1111;3697;2586;2443
SP00588;SP;1646;5167;3521;3249
SP00589;SP;1403;4702;3299;2945
SP00590;SP;2299;7580;5281;4767
SP00591;SP;1863;6263;4400;3968
SP00592;SP;1502;5506;4004;3604
SP00593;SP;1462;5605;4143;3747
SP00594;SP;974;3522;2548;2252
SP00595;SP;971;3557;2586;2360
SP00596;SP;938;3534;2596;2315
SP00597;SP;1503;5301;3798;3363
SP00598;SP;1411;4844;3433;3099
SP00599;SP;1909;6251;4342;3850
SP00600;SP;1116;4185;3069;2750
SP00601;SP;1747;6122;4375;4024
SP00602;SP;1002;3850;2848;2612
SP00603;SP;1499;4959;3460;3080
SP00604;SP;943;3537;2594;2282
SP00605;SP;941;4399;3458;3192
SP00606;SP;520;2414;1894;1733
SP00607;SP;605;2771;2166;1946
SP00608;SP;823;3524;2701;2432
SP00609;SP;468;2139;1671;1494
SP00610;SP;1119;4996;3877;3624
SP00611;SP;403;1902;1499;1356
SP00612;SP;624;2164;1540;1406
SP00613;SP;270;1184;914;823
SP00614;SP;1575;6485;4910;4418
SP00615;SP;219;1062;843;746
SP00616;SP;883;3937;3054;2837
SP00617;SP;393;1349;956;883
SP00618;SP;1727;5671;3944;3552
SP00619;SP;465;1692;1227;1122
SP00620;SP;33;98;65;59
SP00621;SP;2410;7468;5058;4865
SP00622;SP;2632;8525;5893;5639
SP00623;SP;1794;5777;3983;3816
SP00624;SP;2013;6339;4326;4147
SP00625;SP;3154;10784;7630;7349
SP00626;SP;1952;6265;4313;4163
SP00627;SP;2327;7090;4763;4533
SP00628;SP;2215;7913;5698;5552
SP00629;SP;1253;3705;2452;2303
SP00630;SP;1740;5514;3774;3628
SP00631;SP;951;2522;1571;1459
SP00632;SP;2717;9851;7134;6837
SP00633;SP;1159;3955;2796;2708
SP00634;SP;2134;6679;4545;4327
SP00635;SP;1863;5917;4054;3789
SP00636;SP;2262;7155;4893;4683
SP00637;SP;2102;5885;3783;3611
SP00638;SP;2164;6804;4640;4408
SP00639;SP;2755;9027;6272;5998
SP00640;SP;1973;6187;4214;4002
SP00641;SP;2280;6983;4703;4445
SP00642;SP;1296;5042;3746;3522
SP00643;SP;895;3354;2459;2299
SP00644;SP;1585;5516;3931;3760
SP00645;SP;1162;3823;2661;2508
SP00646;SP;950;3531;2581;2445
SP00647;SP;2320;7403;5083;4892
SP00648;SP;964;3841;2877;2733
SP00649;SP;666;2648;1982;1879
SP00650;SP;1154;4689;3535;3393
SP00651;SP;1581;4603;3022;2809
SP00652;SP;1355;4711;3356;3082
SP00653;SP;2887;9758;6871;6586
SP00654;SP;1670;5621;3951;3772
SP00655;SP;1226;4274;3048;2913
SP00656;SP;2117;7540;5423;5139
SP00657;SP;1929;6658;4729;4461
SP00658;SP;1344;4399;3055;2912
SP00659;SP;1223;4066;2843;2695
SP00660;SP;535;1900;1365;1306
SP00661;SP;1203;3498;2295;2116
SP00662;SP;1275;4467;3192;3050
SP00663;SP;1509;4883;3374;3199
SP00664;SP;1238;4189;2951;2798
SP00665;SP;1454;4690;3236;3048
SP00666;SP;1560;4794;3234;3039
SP00667;SP;1994;7365;5371;5034
SP00668;SP;1578;5384;3806;3593
SP00669;SP;1217;4307;3090;2935
SP00670;SP;1547;5766;4219;3993
SP00671;SP;2383;7344;4961;4615
SP00672;SP;1545;5404;3859;3618
SP00673;SP;1015;3585;2570;2428
SP00674;SP;814;3396;2582;2338
SP00675;SP;465;2186;1721;1640
SP00676;SP;914;3751;2837;2653
SP00677;SP;418;1922;1504;1420
SP00678;SP;962;3777;2815;2612
SP00679;SP;1287;4304;3017;2831
SP00680;SP;2792;11486;8694;8233
SP00681;SP;1234;5137;3903;3716
SP00682;SP;547;2306;1759;1678
SP00683;SP;1179;5169;3990;3812
SP00684;SP;394;1542;1148;1090
SP00685;SP;56;329;273;258
SP00686;SP;3129;9715;6586;6066
SP00687;SP;1613;5282;3669;3417
SP00688;SP;1209;4013;2804;2605
SP00689;SP;1864;6259;4395;4101
SP00690;SP;1691;5510;3819;3562
SP00691;SP;674;2030;1356;1262
SP00692;SP;2303;8151;5848;5475
SP00693;SP;1383;4634;3251;3010
SP00694;SP;2246;8474;6228;5860
SP00695;SP;1804;5738;3934;3659
SP00696;SP;315;1384;1069;1007
SP00697;SP;1157;4338;3181;3028
SP00698;SP;1247;4269;3022;2750
SP00699;SP;865;2845;1980;1799
SP00700;SP;742;2038;1296;1203
SP00701;SP;1071;4091;3020;2798
SP00702;SP;1018;3281;2263;2117
SP00703;SP;1073;3713;2640;2382
SP00704;SP;1567;5896;4329;3928
SP00705;SP;775;2464;1689;1561
SP00706;SP;1502;5478;3976;3593
SP00707;SP;2008;6988;4980;4458
SP00708;SP;1758;5710;3952;3529
SP00709;SP;1707;5869;4162;3726
SP00710;SP;1106;3923;2817;2562
SP00711;SP;1283;4783;3500;3195
SP00712;SP;1942;7054;5112;4635
SP00713;SP;1367;5464;4097;3724
SP00714;SP;833;3081;2248;2021
SP00715;SP;1009;4628;3619;3271
SP00716;SP;1345;6085;4740;4264
SP00717;SP;1221;5351;4130;3720
SP00718;SP;1113;3625;2512;2242
SP00719;SP;1771;6130;4359;3919
SP00720;SP;425;2043;1618;1463
SP00721;SP;857;3054;2197;2063
SP00722;SP;692;3108;2416;2188
SP00723;SP;1401;5496;4095;3699
SP00724;SP;965;3664;2699;2534
SP00725;SP;1725;5899;4174;3910
SP00726;SP;1443;4468;3025;2809
SP00727;SP;1398;5267;3869;3548
SP00728;SP;1290;4919;3629;3286
SP00729;SP;2176;8105;5929;5377
SP00730;SP;1349;5502;4153;3748
SP00731;SP;1219;4685;3466;3123
SP00732;SP;985;3768;2783;2477
SP00733;SP;1601;6587;4986;4393
SP00734;SP;959;3871;2912;2590
SP00735;SP;1490;5909;4419;4005
SP00736;SP;1422;6501;5079;4565
SP00737;SP;1419;6265;4846;4370
SP00738;SP;1968;8744;6776;6083
SP00739;SP;431;1868;1437;1321
SP00740;SP;868;3936;3068;2780
SP00741;SP;927;4300;3373;3062
SP00742;SP;1087;5088;4001;3633
SP00743;SP;994;4240;3246;2959
SP00744;SP;1231;5446;4215;3718
SP00745;SP;1233;4714;3481;3283
SP00746;SP;312;1614;1302;1194
SP00747;SP;1163;4941;3778;3429
SP00748;SP;1033;3624;2591;2384
SP00749;SP;416;1955;1539;1379
SP00750;SP;301;1353;1052;967
SP00751;SP;431;1977;1546;1383
SP00752;SP;882;3263;2381;2062
SP00753;SP;351;1731;1380;1254
SP00754;SP;166;1139;973;913
SP00755;SP;701;2817;2116;1899
SP00756;SP;957;3235;2278;2048
SP00757;SP;761;3284;2523;2281
SP00758;SP;900;4241;3341;3016
SP00759;SP;796;3490;2694;2390
SP00760;SP;1771;6093;4322;3865
SP00761;SP;887;3317;2430;2172
SP00762;SP;924;4199;3275;2932
SP00763;SP;618;2894;2276;2054
SP00764;SP;257;1319;1062;929
SP00765;SP;2514;8135;5621;5233
SP00766;SP;2085;7053;4968;4597
SP00767;SP;1983;6440;4457;4149
SP00768;SP;1362;4292;2930;2732
SP00769;SP;1614;5078;3464;3221
SP00770;SP;1947;6150;4203;3800
SP00771;SP;2272;7436;5164;4740
SP00772;SP;1547;5664;4117;3665
SP00773;SP;1838;6264;4426;4024
SP00774;SP;2062;7854;5792;5286
SP00775;SP;2144;7449;5305;4751
SP00776;SP;1902;6598;4696;4244
SP00777;SP;1815;5853;4038;3544
SP00778;SP;2212;7392;5180;4520
SP00779;SP;2024;7813;5789;5103
SP00780;SP;877;3820;2943;2695
SP00781;SP;1188;4179;2991;2681
SP00782;SP;1694;6626;4932;4346
SP00783;SP;239;823;584;553
SP00784;SP;776;3105;2329;2069
SP00785;SP;448;1882;1434;1323
SP00786;SP;1137;4539;3402;3036
SP00787;SP;569;2366;1797;1621
SP00788;SP;1808;6979;5171;4448
SP00789;SP;436;1625;1189;1116
SP00790;SP;384;1404;1020;951
SP00791;SP;305;1168;863;780
SP00792;SP;696;2736;2040;1846
SP00793;SP;602;2523;1921;1710
SP00794;SP;1415;5472;4057;3583
SP00795;SP;1361;5107;3746;3355
SP00796;SP;291;1001;710;634
SP00797;SP;1027;3693;2666;2468
SP00798;SP;790;3561;2771;2601
SP00799;SP;2163;7792;5629;4943
SP00800;SP;1398;5404;4006;3653
SP00801;SP;909;3726;2817;2598
SP00802;SP;586;2293;1707;1473
SP00803;SP;970;3495;2525;2238
SP00804;SP;358;1445;1087;953
SP00805;SP;2003;6882;4879;4361
SP00806;SP;1563;5119;3556;3197
SP00807;SP;1278;4221;2943;2676
SP00808;SP;1605;5967;4362;3995
SP00809;SP;1247;4931;3684;3427
SP00810;SP;1287;4312;3025;2756
SP00811;SP;1468;4790;3322;3021
SP00812;SP;2030;6537;4507;4071
SP00813;SP;1690;5405;3715;3429
SP00814;SP;1069;3409;2340;2158
SP00815;SP;1456;4827;3371;3069
SP00816;SP;1333;4010;2677;2395
SP00817;SP;1526;5075;3549;3130
SP00818;SP;1051;4699;3648;3260
SP00819;SP;325;1557;1232;1117
SP00820;SP;742;2998;2256;2080
SP00821;SP;803;3156;2353;2159
SP00822;SP;454;1894;1440;1305
SP00823;SP;669;2754;2085;1908
SP00824;SP;1303;5510;4207;3855
SP00825;SP;881;3960;3079;2883
SP00826;SP;494;2231;1737;1602
SP00827;SP;1826;7530;5704;5280
SP00828;SP;4;40;36;35
SP00829;SP;270;1366;1096;1041
SP00830;SP;378;1919;1541;1441
SP00831;SP;732;3038;2306;2080
SP00832;SP;1251;4365;3114;2887
SP00833;SP;1422;5058;3636;3313
SP00834;SP;917;3451;2534;2371
SP00835;SP;1245;4136;2891;2599
SP00836;SP;1498;4922;3424;3076
SP00837;SP;485;2272;1787;1638
SP00838;SP;1212;4893;3681;3293
SP00839;SP;248;942;694;645
SP00840;SP;198;990;792;731
SP00841;SP;1583;6587;5004;4505
SP00842;SP;1972;6278;4306;3842
SP00843;SP;1709;5641;3932;3457
SP00844;SP;378;1541;1163;1019
SP00845;SP;411;1830;1419;1258
SP00846;SP;2053;7352;5299;4594
SP00847;SP;1026;4082;3056;2680
SP00848;SP;1617;5251;3634;3215
SP00849;SP;796;3277;2481;2227
SP00850;SP;1407;5224;3817;3360
SP00851;SP;1798;5695;3897;3445
SP00852;SP;447;1783;1336;1187
SP00853;SP;1041;4081;3040;2702
SP00854;SP;1830;6049;4219;3710
SP00855;SP;889;3058;2169;1971
SP00856;SP;1524;6062;4538;3965
SP00857;SP;683;3507;2824;2520
SP00858;SP;1507;6096;4589;4012
SP00859;SP;1029;4366;3337;2989
SP00860;SP;665;3076;2411;2167
SP00861;SP;894;3884;2990;2527
SP00862;SP;1121;4149;3028;2658
SP00863;SP;879;3714;2835;2563
SP00864;SP;477;2151;1674;1523
SP00865;SP;1252;5331;4079;3676
SP00866;SP;504;2305;1801;1597
SP00867;SP;469;2195;1726;1512
SP00868;SP;1162;4537;3375;2962
SP00869;SP;574;2469;1895;1630
SP00870;SP;347;1214;867;734
SP00871;SP;1009;4180;3171;2752
SP00872;SP;1187;4150;2963;2530
SP00873;SP;1589;5220;3631;3177
SP00874;SP;884;3637;2753;2442
SP00875;SP;999;4489;3490;3034
SP00876;SP;1072;4758;3686;3209
SP00877;SP;570;2332;1762;1564
SP00878;SP;1043;4052;3009;2623
SP00879;SP;1597;5137;3540;3060
SP00880;SP;942;4156;3214;2820
SP00881;SP;275;1173;898;802
SP00882;SP;471;1968;1497;1289
SP00883;SP;334;1492;1158;1013
SP00884;SP;1908;6025;4117;3740
SP00885;SP;1064;3760;2696;2397
SP00886;SP;1095;3614;2519;2299
SP00887;SP;771;2549;1778;1626
SP00888;SP;803;3225;2422;2268
SP00889;SP;1287;4118;2831;2624
SP00890;SP;1836;6506;4670;4310
SP00891;SP;1571;6195;4624;4237
SP00892;SP;1413;4485;3072;2805
SP00893;SP;1252;4866;3614;3312
SP00894;SP;1201;4335;3134;2930
SP00895;SP;1486;4545;3059;2771
SP00896;SP;1125;3683;2558;2297
SP00897;SP;1112;4232;3120;2793
SP00898;SP;1363;4477;3114;2828
SP00899;SP;930;3360;2430;2284
SP00900;SP;1238;4799;3561;3150
SP00901;SP;1226;4411;3185;2788
SP00902;SP;870;3771;2901;2611
SP00903;SP;436;1833;1397;1304
SP00904;SP;302;1355;1053;957
SP00905;SP;1315;5577;4262;3813
SP00906;SP;392;1659;1267;1151
SP00907;SP;842;3598;2756;2451
SP00908;SP;507;2080;1573;1408
SP00909;SP;546;2198;1652;1520
SP00910;SP;170;884;714;669
SP00911;SP;741;2895;2154;1990
SP00912;SP;523;2322;1799;1669
SP00913;SP;879;3776;2897;2522
SP00914;SP;216;1086;870;777
SP00915;SP;460;1861;1401;1239
SP00916;SP;316;1311;995;879
SP00917;SP;64;310;246;227
SP00918;SP;374;1646;1272;1131
SP00919;SP;253;1249;996;881
SP00920;SP;1844;6672;4828;4222
SP00921;SP;359;1221;862;749
SP00922;SP;2549;8638;6089;5400
SP00923;SP;1881;5779;3898;3490
SP00924;SP;1666;5898;4232;3763
SP00925;SP;1463;5327;3864;3431
SP00926;SP;1640;5575;3935;3541
SP00927;SP;1295;4583;3288;3004
SP00928;SP;1183;5132;3949;3568
SP00929;SP;575;2588;2013;1811
SP00930;SP;658;2858;2200;1961
SP00931;SP;355;1575;1220;1128
SP00932;SP;830;3504;2674;2297
SP00933;SP;1776;6037;4261;3866
SP00934;SP;1547;5284;3737;3355
SP00935;SP;1948;6922;4974;4453
SP00936;SP;1905;6913;5008;4417
SP00937;SP;1493;5631;4138;3702
SP00938;SP;2227;7741;5514;4913
SP00939;SP;1846;6851;5005;4527
SP00940;SP;2241;7378;5137;4531
SP00941;SP;2262;8289;6027;5363
SP00942;SP;1483;6510;5027;4496
SP00943;SP;1498;5578;4080;3623
SP00944;SP;1830;6614;4784;4198
SP00945;SP;1708;6631;4923;4415
SP00946;SP;1104;4553;3449;3030
SP00947;SP;1664;6568;4904;4308
SP00948;SP;1470;6371;4901;4307
SP00949;SP;1602;6028;4426;3908
SP00950;SP;1701;6838;5137;4549
SP00951;SP;1636;6758;5122;4527
SP00952;SP;4403;13315;8912;8050
SP00953;SP;1633;6513;4880;4404
SP00954;SP;1257;4954;3697;3284
SP00955;SP;1047;4285;3238;2944
SP00956;SP;1875;6086;4211;3805
SP00957;SP;1676;6423;4747;4224
SP00958;SP;2066;5350;3284;2978
SP00959;SP;2018;7126;5108;4526
SP00960;SP;1043;3791;2748;2473
SP00961;SP;353;1021;668;580
SP00962;SP;213;709;496;418
SP00963;SP;171;706;535;491
SP00964;SP;3873;11909;8036;7711
SP00965;SP;1857;6230;4373;4089
SP00966;SP;1417;4337;2920;2684
SP00967;SP;1294;4335;3041;2783
SP00968;SP;1631;5544;3913;3628
SP00969;SP;1629;5494;3865;3460
SP00970;SP;1358;4314;2956;2794
SP00971;SP;1411;4461;3050;2866
SP00972;SP;1777;5527;3750;3495
SP00973;SP;1310;4361;3051;2852
SP00974;SP;1090;3974;2884;2747
SP00975;SP;1857;5925;4068;3742
SP00976;SP;825;3374;2549;2424
SP00977;SP;1431;4747;3316;3042
SP00978;SP;1370;4720;3350;3145
SP00979;SP;997;3936;2939;2696
SP00980;SP;1390;4362;2972;2847
SP00981;SP;1624;4660;3036;2891
SP00982;SP;1676;5546;3870;3645
SP00983;SP;1170;4483;3313;3052
SP00984;SP;616;2369;1753;1631
SP00985;SP;806;3154;2348;2167
SP00986;SP;661;2746;2085;1909
SP00987;SP;1255;4690;3435;3001
SP00988;SP;1292;5130;3838;3609
SP00989;SP;1261;4732;3471;3218
SP00990;SP;806;3164;2358;2177
SP00991;SP;1011;3538;2527;2349
SP00992;SP;455;1966;1511;1364
SP00993;SP;354;1554;1200;1064
SP00994;SP;849;3170;2321;2174
SP00995;SP;870;3591;2721;2600
SP00996;SP;403;1564;1161;1073
SP00997;SP;106;391;285;270
SP00998;SP;212;790;578;547
SP00999;SP;215;789;574;505
SP01000;SP;1632;5650;4018;3735
SP01001;SP;1706;5804;4098;3866
SP01002;SP;1101;3956;2855;2616
SP01003;SP;1491;6014;4523;4285
SP01004;SP;2534;8670;6136;5801
SP01005;SP;1664;5082;3418;3224
SP01006;SP;1284;5115;3831;3584
SP01007;SP;922;3314;2392;2193
SP01008;SP;957;3674;2717;2485
SP01009;SP;800;3257;2457;2274
SP01010;SP;756;2767;2011;1872
SP01011;SP;1111;4250;3139;2863
SP01012;SP;2702;9040;6338;5836
SP01013;SP;1487;5581;4094;3693
SP01014;SP;936;3487;2551;2279
SP01015;SP;1517;5212;3695;3352
SP01016;SP;2241;7681;5440;4737
SP01017;SP;1228;3849;2621;2330
SP01018;SP;1287;4200;2913;2584
SP01019;SP;864;3579;2715;2443
SP01020;SP;353;1678;1325;1185
SP01021;SP;1808;5856;4048;3596
SP01022;SP;1890;7237;5347;4866
SP01023;SP;1545;5047;3502;3139
SP01024;SP;305;1053;748;677
SP01025;SP;1156;3899;2743;2497
SP01026;SP;1309;4576;3267;2914
SP01027;SP;963;3926;2963;2647
SP01028;SP;1259;4443;3184;2856
SP01029;SP;766;3145;2379;2102
SP01030;SP;745;3473;2728;2458
SP01031;SP;978;4290;3312;2976
SP01032;SP;1201;4988;3787;3368
SP01033;SP;1041;4681;3640;3260
SP01034;SP;986;3909;2923;2629
SP01035;SP;1734;6691;4957;4461
SP01036;SP;941;4224;3283;2981
SP01037;SP;1256;5057;3801;3358
SP01038;SP;824;3517;2693;2413
SP01039;SP;913;3823;2910;2500
SP01040;SP;918;3542;2624;2341
SP01041;SP;345;1390;1045;952
SP01042;SP;1102;4324;3222;2860
SP01043;SP;357;1572;1215;1076
SP01044;SP;1083;4726;3643;3278
SP01045;SP;1144;4702;3558;3198
SP01046;SP;359;1567;1208;1075
SP01047;SP;622;2728;2106;1848
SP01048;SP;366;1647;1281;1151
SP01049;SP;554;2385;1831;1631
SP01050;SP;456;1959;1503;1357
SP01051;SP;720;3156;2436;2170
SP01052;SP;1772;6139;4367;4009
SP01053;SP;1807;5114;3307;2985
SP01054;SP;1323;4275;2952;2664
SP01055;SP;1632;5802;4170;3743
SP01056;SP;1835;6196;4361;3971
SP01057;SP;1629;6658;5029;4626
SP01058;SP;1477;5074;3597;3244
SP01059;SP;1382;5785;4403;4017
SP01060;SP;1416;5345;3929;3593
SP01061;SP;1179;4129;2950;2642
SP01062;SP;916;2994;2078;1898
SP01063;SP;1259;4282;3023;2611
SP01064;SP;1568;6076;4508;3996
SP01065;SP;1006;3662;2656;2404
SP01066;SP;741;2883;2142;1974
SP01067;SP;752;3428;2676;2356
SP01068;SP;951;3742;2791;2446
SP01069;SP;660;3158;2498;2322
SP01070;SP;731;3112;2381;2167
SP01071;SP;364;1661;1297;1161
SP01072;SP;236;1029;793;718
SP01073;SP;603;2744;2141;1959
SP01074;SP;302;1372;1070;929
SP01075;SP;327;1334;1007;906
SP01076;SP;701;3137;2436;2236
SP01077;SP;594;3176;2582;2426
SP01078;SP;3099;10615;7516;6696
SP01079;SP;2431;8588;6157;5426
SP01080;SP;1064;3811;2747;2413
SP01081;SP;1162;4604;3442;3068
SP01082;SP;927;2526;1599;1391
SP01083;SP;1026;3114;2088;1885
SP01084;SP;871;4187;3316;2955
SP01085;SP;826;3957;3131;2778
SP01086;SP;1043;4668;3625;3209
SP01087;SP;700;3331;2631;2370
SP01088;SP;166;889;723;650
SP01089;SP;1311;5551;4240;3833
SP01090;SP;1059;4652;3593;3177
SP01091;SP;677;3433;2756;2417
SP01092;SP;2048;5885;3837;3441
SP01093;SP;1752;5944;4192;3769
SP01094;SP;1491;4951;3460;3166
SP01095;SP;1700;5974;4274;3803
SP01096;SP;1250;4179;2929;2634
SP01097;SP;2237;7641;5404;4956
SP01098;SP;1626;5642;4016;3697
SP01099;SP;1301;4340;3039;2757
SP01100;SP;1271;4090;2819;2551
SP01101;SP;1570;5144;3574;3269
SP01102;SP;1032;3065;2033;1847
SP01103;SP;1463;5564;4101;3810
SP01104;SP;1123;3373;2250;1976
SP01105;SP;1658;5682;4024;3674
SP01106;SP;2530;8626;6096;5278
SP01107;SP;2573;8910;6337;5490
SP01108;SP;796;3363;2567;2290
SP01109;SP;819;3179;2360;1990
SP01110;SP;962;3484;2522;2225
SP01111;SP;437;1699;1262;1137
SP01112;SP;463;1834;1371;1176
SP01113;SP;1233;5153;3920;3592
SP01114;SP;369;1783;1414;1292
SP01115;SP;426;2032;1606;1452
SP01116;SP;793;3795;3002;2819
SP01117;SP;196;703;507;446
SP01118;SP;922;3117;2195;1941
SP01119;SP;187;893;706;619
SP01120;SP;2057;6954;4897;4262
SP01121;SP;572;2241;1669;1464
SP01122;SP;1116;3123;2007;1734
SP01123;SP;2405;8211;5806;5143
SP01124;SP;2003;6479;4476;3881
SP01125;SP;959;3476;2517;2221
SP01126;SP;1883;6161;4278;3867
SP01127;SP;2266;7942;5676;5033
SP01128;SP;1451;4920;3469;3124
SP01129;SP;1676;6181;4505;3991
SP01130;SP;1815;6066;4251;3803
SP01131;SP;1387;5996;4609;4098
SP01132;SP;1812;5881;4069;3658
SP01133;SP;1725;5893;4168;3716
SP01134;SP;1237;4563;3326;2951
SP01135;SP;1513;5468;3955;3502
SP01136;SP;1561;6560;4999;4443
SP01137;SP;288;1190;902;820
SP01138;SP;813;3414;2601;2336
SP01139;SP;692;2703;2011;1760
SP01140;SP;1073;4702;3629;3277
SP01141;SP;1660;6662;5002;4489
SP01142;SP;1157;5011;3854;3443
SP01143;SP;758;3097;2339;2118
SP01144;SP;705;3086;2381;2105
SP01145;SP;1240;5008;3768;3282
SP01146;SP;1088;4300;3212;2836
SP01147;SP;613;2332;1719;1550
SP01148;SP;626;2683;2057;1794
SP01149;SP;807;3540;2733;2503
SP01150;SP;428;1851;1423;1249
SP01151;SP;162;692;530;462
SP01152;SP;267;1143;876;777
SP01153;SP;3346;12021;8675;7543
SP01154;SP;1776;7187;5411;4666
SP01155;SP;1122;4827;3705;3216
SP01156;SP;1150;4593;3443;3002
SP01157;SP;1713;6773;5060;4423
SP01158;SP;1659;6016;4357;3746
SP01159;SP;649;2758;2109;1825
SP01160;SP;419;1821;1402;1184
SP01161;SP;581;2722;2141;1875
SP01162;SP;315;1286;971;845
SP01163;SP;1326;4114;2788;2511
SP01164;SP;1820;5708;3888;3510
SP01165;SP;1112;3908;2796;2560
SP01166;SP;1519;5277;3758;3330
SP01167;SP;1809;6259;4450;3857
SP01168;SP;1822;5911;4089;3706
SP01169;SP;1826;6535;4709;4207
SP01170;SP;2257;7817;5560;4925
SP01171;SP;1861;6620;4759;4198
SP01172;SP;1801;6690;4889;4508
SP01173;SP;1222;4537;3315;2967
SP01174;SP;1916;6350;4434;3921
SP01175;SP;1251;4660;3409;3034
SP01176;SP;2485;8236;5751;5001
SP01177;SP;1235;4264;3029;2761
SP01178;SP;2131;7018;4887;4217
SP01179;SP;825;3692;2867;2584
SP01180;SP;1294;4666;3372;2916
SP01181;SP;1289;4741;3452;3075
SP01182;SP;1514;5929;4415;4150
SP01183;SP;1718;6376;4658;4337
SP01184;SP;1062;4359;3297;2978
SP01185;SP;929;3511;2582;2235
SP01186;SP;785;3559;2774;2578
SP01187;SP;633;2356;1723;1485
SP01188;SP;434;1590;1156;1027
SP01189;SP;1871;5883;4012;3572
SP01190;SP;1538;5137;3599;3201
SP01191;SP;2054;7205;5151;4453
SP01192;SP;1508;5481;3973;3473
SP01193;SP;2025;6918;4893;4244
SP01194;SP;845;3150;2305;2000
SP01195;SP;1620;5991;4371;3776
SP01196;SP;1815;6441;4626;4044
SP01197;SP;1539;6065;4526;3915
SP01198;SP;994;4394;3400;2969
SP01199;SP;1132;4561;3429;2987
SP01200;SP;1272;4925;3653;3094
SP01201;SP;1460;5937;4477;3808
SP01202;SP;1623;6413;4790;4188
SP01203;SP;1188;5224;4036;3552
SP01204;SP;1268;5365;4097;3600
SP01205;SP;1598;6483;4885;4249
SP01206;SP;1164;4510;3346;2988
SP01207;SP;1055;4349;3294;2882
SP01208;SP;1660;6891;5231;4537
SP01209;SP;2061;7838;5777;4973
SP01210;SP;722;3150;2428;2062
SP01211;SP;1111;4601;3490;2958
SP01212;SP;1771;7434;5663;5006
SP01213;SP;1084;4450;3366;2935
SP01214;SP;1400;5318;3918;3343
SP01215;SP;1612;6563;4951;4248
SP01216;SP;1096;4894;3798;3196
SP01217;SP;566;2233;1667;1397
SP01218;SP;272;1256;984;820
SP01219;SP;874;3597;2723;2321
SP01220;SP;543;2623;2080;1779
SP01221;SP;1148;4891;3743;3234
SP01222;SP;458;2122;1664;1414
SP01223;SP;1129;3886;2757;2441
SP01224;SP;645;2283;1638;1422
SP01225;SP;100;458;358;307
SP01226;SP;238;959;721;606
SP01227;SP;1106;4013;2907;2532
SP01228;SP;1199;4077;2878;2453
SP01229;SP;1299;5709;4410;3825
SP01230;SP;759;2563;1804;1546
SP01231;SP;1512;4357;2845;2525
SP01232;SP;1364;4544;3180;2758
SP01233;SP;974;3348;2374;2061
SP01234;SP;482;1567;1085;935
SP01235;SP;2121;7584;5463;4655
SP01236;SP;1311;4335;3024;2607
SP01237;SP;1765;5922;4157;3581
SP01238;SP;1074;4275;3201;2740
SP01239;SP;1417;6020;4603;3951
SP01240;SP;490;2099;1609;1399
SP01241;SP;1719;6681;4962;4241
SP01242;SP;864;3576;2712;2350
SP01243;SP;1106;4912;3806;3313
SP01244;SP;795;3449;2654;2317
SP01245;SP;1801;7927;6126;5373
SP01246;SP;1463;6332;4869;4202
SP01247;SP;1135;4854;3719;3235
SP01248;SP;1581;6322;4741;4109
SP01249;SP;2221;7808;5587;4801
SP01250;SP;1045;4254;3209;2779
SP01251;SP;1497;5249;3752;3249
SP01252;SP;923;3905;2982;2543
SP01253;SP;375;1578;1203;1059
SP01254;SP;1839;7148;5309;4626
SP01255;SP;1338;5145;3807;3236
SP01256;SP;1732;6264;4532;3944
SP01257;SP;809;3540;2731;2355
SP01258;SP;942;3588;2646;2276
SP01259;SP;433;1800;1367;1201
SP01260;SP;1485;5635;4150;3556
SP01261;SP;1067;4017;2950;2557
SP01262;SP;1044;4424;3380;2910
SP01263;SP;1336;3672;2336;1991
SP01264;SP;408;1742;1334;1118
SP01265;SP;670;2308;1638;1393
SP01266;SP;673;2296;1623;1411
SP01267;SP;994;3668;2674;2299
SP01268;SP;367;1395;1028;899
SP01269;SP;300;1317;1017;874
SP01270;SP;186;767;581;509
SP01271;SP;1177;3998;2821;2542
SP01272;SP;898;3598;2700;2426
SP01273;SP;1995;6832;4837;4316
SP01274;SP;1938;6482;4544;4029
SP01275;SP;2370;8215;5845;5265
SP01276;SP;1569;5814;4245;3744
SP01277;SP;1271;5451;4180;3715
SP01278;SP;1798;6124;4326;3838
SP01279;SP;1811;7160;5349;4714
SP01280;SP;1383;5845;4462;3951
SP01281;SP;1351;6196;4845;4350
SP01282;SP;2140;8652;6512;5817
SP01283;SP;978;4641;3663;3368
SP01284;SP;661;2886;2225;1986
SP01285;SP;1032;4343;3311;2984
SP01286;SP;1144;5329;4185;3770
SP01287;SP;1031;4630;3599;3263
SP01288;SP;841;3628;2787;2512
SP01289;SP;1925;8261;6336;5625
SP01290;SP;1366;5911;4545;4081
SP01291;SP;462;2147;1685;1522
SP01292;SP;1403;5775;4372;3949
SP01293;SP;1924;8374;6450;5808
SP01294;SP;1152;5309;4157;3699
SP01295;SP;670;3038;2368;2129
SP01296;SP;474;1918;1444;1312
SP01297;SP;1084;5073;3989;3512
SP01298;SP;1112;4397;3285;2937
SP01299;SP;893;3911;3018;2702
SP01300;SP;753;3153;2400;2207
SP01301;SP;470;2227;1757;1575
SP01302;SP;629;2717;2088;1887
SP01303;SP;1032;4518;3486;3136
SP01304;SP;964;3849;2885;2564
SP01305;SP;956;3647;2691;2402
SP01306;SP;2527;10069;7542;6674
SP01307;SP;1204;5091;3887;3447
SP01308;SP;986;4137;3151;2804
SP01309;SP;710;3292;2582;2342
SP01310;SP;1295;5036;3741;3352
SP01311;SP;56;289;233;221
SP01312;SP;1230;4582;3352;2891
SP01313;SP;1284;5646;4362;3848
SP01314;SP;1376;4826;3450;3040
SP01315;SP;1726;5836;4110;3619
SP01316;SP;2133;6703;4570;4078
SP01317;SP;2266;7496;5230;4613
SP01318;SP;1812;5897;4085;3656
SP01319;SP;1955;6497;4542;3958
SP01320;SP;2190;8209;6019;5317
SP01321;SP;1210;5117;3907;3487
SP01322;SP;1451;6445;4994;4402
SP01323;SP;1663;6741;5078;4526
SP01324;SP;452;1575;1123;990
SP01325;SP;637;2946;2309;2036
SP01326;SP;1234;4913;3679;3172
SP01327;SP;1657;5676;4019;3516
SP01328;SP;1425;6187;4762;4248
SP01329;SP;892;3596;2704;2348
SP01330;SP;1633;7538;5905;5381
SP01331;SP;512;1932;1420;1244
SP01332;SP;1370;5043;3673;3227
SP01333;SP;2423;8821;6398;5618
SP01334;SP;1474;5470;3996;3544
SP01335;SP;1903;7407;5504;4783
SP01336;SP;1656;6381;4725;4087
SP01337;SP;1484;5929;4445;3891
SP01338;SP;2958;10511;7553;6604
SP01339;SP;1736;6726;4990;4362
SP01340;SP;1601;6735;5134;4545
SP01341;SP;749;3295;2546;2182
SP01342;SP;408;1975;1567;1403
SP01343;SP;527;2274;1747;1538
SP01344;SP;487;1994;1507;1350
SP01345;SP;811;3443;2632;2317
SP01346;SP;1065;4333;3268;2880
SP01347;SP;1972;7950;5978;5442
SP01348;SP;1015;3369;2354;2058
SP01349;SP;1957;7723;5766;5072
SP01350;SP;2464;8729;6265;5416
SP01351;SP;383;1693;1310;1134
SP01352;SP;2563;9339;6776;5976
SP01353;SP;950;3717;2767;2403
SP01354;SP;1883;7702;5819;5063
SP01355;SP;428;1496;1068;936
SP01356;SP;293;1180;887;776
SP01357;SP;594;2333;1739;1534
SP01358;SP;317;931;614;552
SP01359;SP;266;839;573;498
SP01360;SP;1372;4177;2805;2518
SP01361;SP;2306;7818;5512;4949
SP01362;SP;2279;7767;5488;4941
SP01363;SP;1698;5696;3998;3484
SP01364;SP;873;3423;2550;2236
SP01365;SP;1296;4472;3176;2790
SP01366;SP;1845;6944;5099;4461
SP01367;SP;1303;4323;3020;2694
SP01368;SP;1591;6668;5077;4519
SP01369;SP;751;3307;2556;2233
SP01370;SP;1541;6243;4702;4183
SP01371;SP;2044;7808;5764;5049
SP01372;SP;663;2774;2111;1886
SP01373;SP;1783;6512;4729;4169
SP01374;SP;753;3027;2274;2041
SP01375;SP;1004;4586;3582;3214
SP01376;SP;644;2812;2168;1956
SP01377;SP;1833;6246;4413;3830
SP01378;SP;1325;5134;3809;3335
SP01379;SP;505;1511;1006;905
SP01380;SP;1646;6398;4752;4316
SP01381;SP;1389;5235;3846;3384
SP01382;SP;1262;4773;3511;3083
SP01383;SP;976;3644;2668;2378
SP01384;SP;359;1615;1256;1137
SP01385;SP;741;2603;1862;1656
SP01386;SP;1442;5463;4021;3562
SP01387;SP;731;3279;2548;2234
SP01388;SP;1067;4349;3282;2911
SP01389;SP;1598;5537;3939;3498
SP01390;SP;1467;5471;4004;3573
SP01391;SP;1427;5920;4493;3998
SP01392;SP;1260;5417;4157;3701
SP01393;SP;1247;4576;3329;2957
SP01394;SP;719;3196;2477;2198
SP01395;SP;1714;5978;4264;3934
SP01396;SP;1780;6178;4398;3785
SP01397;SP;2555;8800;6245;5605
SP01398;SP;1300;4499;3199;2816
SP01399;SP;2424;8543;6119;5337
SP01400;SP;1523;5413;3890;3412
SP01401;SP;2666;8695;6029;5572
SP01402;SP;1750;5706;3956;3565
SP01403;SP;1552;4451;2899;2568
SP01404;SP;1810;6132;4322;3837
SP01405;SP;1520;6097;4577;4113
SP01406;SP;1284;4561;3277;2885
SP01407;SP;1777;5751;3974;3543
SP01408;SP;1053;3519;2466;2207
SP01409;SP;1509;4997;3488;3180
SP01410;SP;1697;6568;4871;4604
SP01411;SP;1205;5127;3922;3468
SP01412;SP;1617;6509;4892;4341
SP01413;SP;1692;5838;4146;3672
SP01414;SP;2992;11881;8889;7974
SP01415;SP;1355;5045;3690;3257
SP01416;SP;874;3507;2633;2279
SP01417;SP;2177;8205;6028;5308
SP01418;SP;952;3824;2872;2569
SP01419;SP;845;3045;2200;1950
SP01420;SP;908;3530;2622;2277
SP01421;SP;2635;9984;7349;6818
SP01422;SP;895;3948;3053;2730
SP01423;SP;687;3120;2433;2156
SP01424;SP;552;2544;1992;1760
SP01425;SP;849;3763;2914;2663
SP01426;SP;1021;4324;3303;3036
SP01427;SP;4137;13842;9705;8889
SP01428;SP;232;957;725;647
SP01429;SP;1869;6808;4939;4295
SP01430;SP;778;2960;2182;1957
SP01431;SP;366;1550;1184;1064
SP01432;SP;612;2374;1762;1626
SP01433;SP;444;2066;1622;1403
SP01434;SP;290;1266;976;903
SP01435;SP;420;1570;1150;1006
SP01436;SP;1167;3934;2767;2419
SP01437;SP;1326;5207;3881;3356
SP01438;SP;2005;7108;5103;4540
SP01439;SP;1271;4463;3192;2834
SP01440;SP;1392;4739;3347;2880
SP01441;SP;2035;6375;4340;3710
SP01442;SP;1271;5335;4064;3499
SP01443;SP;1457;6125;4668;4090
SP01444;SP;1152;5456;4304;3783
SP01445;SP;1317;5567;4250;3683
SP01446;SP;1124;4917;3793;3310
SP01447;SP;1016;4389;3373;2967
SP01448;SP;639;2723;2084;1859
SP01449;SP;1027;4414;3387;2966
SP01450;SP;1426;5727;4301;3761
SP01451;SP;1092;4196;3104;2671
SP01452;SP;1383;5785;4402;3828
SP01453;SP;1700;6778;5078;4370
SP01454;SP;972;4757;3785;3340
SP01455;SP;1223;5140;3917;3490
SP01456;SP;1268;5392;4124;3613
SP01457;SP;1248;4727;3479;2950
SP01458;SP;1031;4088;3057;2744
SP01459;SP;1119;4391;3272;2874
SP01460;SP;751;3158;2407;2125
SP01461;SP;1686;6903;5217;4584
SP01462;SP;1842;7003;5161;4481
SP01463;SP;1176;4734;3558;3155
SP01464;SP;1087;4055;2968;2573
SP01465;SP;955;3773;2818;2396
SP01466;SP;1291;5214;3923;3405
SP01467;SP;767;3037;2270;1981
SP01468;SP;759;3098;2339;2060
SP01469;SP;1344;5075;3731;3234
SP01470;SP;906;3423;2517;2181
SP01471;SP;405;1901;1496;1299
SP01472;SP;909;3226;2317;2035
SP01473;SP;1848;5784;3936;3377
SP01474;SP;2102;7185;5083;4535
SP01475;SP;1209;3961;2752;2429
SP01476;SP;1266;4315;3049;2671
SP01477;SP;1926;6382;4456;3956
SP01478;SP;2544;7765;5221;4569
SP01479;SP;1658;7013;5355;4658
SP01480;SP;2092;6794;4702;4169
SP01481;SP;788;2868;2080;1806
SP01482;SP;1699;6480;4781;4110
SP01483;SP;1426;5423;3997;3531
SP01484;SP;1166;4803;3637;3208
SP01485;SP;1058;4366;3308;2932
SP01486;SP;1537;6492;4955;4417
SP01487;SP;1205;5209;4004;3538
SP01488;SP;1048;4853;3805;3404
SP01489;SP;2086;7577;5491;4791
SP01490;SP;1164;5134;3970;3542
SP01491;SP;1389;4927;3538;3139
SP01492;SP;1899;6727;4828;4222
SP01493;SP;1010;3722;2712;2415
SP01494;SP;1900;6825;4925;4309
SP01495;SP;1369;5651;4282;3771
SP01496;SP;1351;5781;4430;3904
SP01497;SP;1389;5264;3875;3457
SP01498;SP;1465;5725;4260;3772
SP01499;SP;586;2259;1673;1501
SP01500;SP;368;1399;1031;928
SP01501;SP;222;923;701;621
SP01502;SP;995;4069;3074;2732
SP01503;SP;1533;5963;4430;3835
SP01504;SP;1104;3973;2869;2569
SP01505;SP;282;1275;993;883
SP01506;SP;973;3179;2206;1958
SP01507;SP;543;2166;1623;1470
SP01508;SP;600;2503;1903;1691
SP01509;SP;563;2116;1553;1373
SP01510;SP;508;2124;1616;1403
SP01511;SP;302;1342;1040;932
SP01512;SP;369;1736;1367;1191
SP01513;SP;1054;3487;2433;2134
SP01514;SP;374;980;606;517
SP01515;SP;73;216;143;120
SP01516;SP;100;273;173;150
SP01517;SP;2102;8843;6741;6026
SP01518;SP;1575;6543;4968;4384
SP01519;SP;868;3483;2615;2301
SP01520;SP;1180;4453;3273;2875
SP01521;SP;1662;6526;4864;4328
SP01522;SP;590;2437;1847;1641
SP01523;SP;1481;6929;5448;4814
SP01524;SP;1621;6877;5256;4666
SP01525;SP;1787;5422;3635;3202
SP01526;SP;1321;5784;4463;3989
SP01527;SP;1434;5330;3896;3460
SP01528;SP;753;3192;2439;2168
SP01529;SP;1985;8092;6107;5375
SP01530;SP;1050;4997;3947;3513
SP01531;SP;543;2226;1683;1487
SP01532;SP;1950;6761;4811;4244
SP01533;SP;1876;7786;5910;5247
SP01534;SP;1050;4049;2999;2659
SP01535;SP;1185;4410;3225;2867
SP01536;SP;1561;6545;4984;4440
SP01537;SP;1372;6049;4677;4121
SP01538;SP;1068;4587;3519;3098
SP01539;SP;590;2252;1662;1477
SP01540;SP;775;3159;2384;2096
SP01541;SP;886;3438;2552;2199
SP01542;SP;345;1396;1051;914
SP01543;SP;1672;6952;5280;4617
SP01544;SP;1115;4162;3047;2655
SP01545;SP;864;3463;2599;2291
SP01546;SP;1106;4679;3573;3189
SP01547;SP;767;2943;2176;1913
SP01548;SP;1276;5863;4587;4067
SP01549;SP;1108;4270;3162;2813
SP01550;SP;267;1274;1007;897
SP01551;SP;962;3659;2697;2340
SP01552;SP;989;3370;2381;2091
SP01553;SP;1466;5645;4179;3664
SP01554;SP;1441;5840;4399;3859
SP01555;SP;859;3529;2670;2370
SP01556;SP;686;2397;1711;1505
SP01557;SP;948;2937;1989;1748
SP01558;SP;1187;4788;3601;3171
SP01559;SP;295;1425;1130;969
SP01560;SP;446;1433;987;860
SP01561;SP;319;1622;1303;1154
SP01562;SP;375;1550;1175;1032
SP01563;SP;526;1842;1316;1181
SP01564;SP;325;1289;964;853
SP01565;SP;259;1058;799;721
SP01566;SP;745;2212;1467;1281
SP01567;SP;156;425;269;236
SP01568;SP;171;443;272;236
SP01569;SP;167;570;403;353
SP01570;SP;11;80;69;59
SP01571;SP;13;115;102;92
SP01572;SP;26;253;227;197
SP01573;SP;17;70;53;48
SP01574;SP;2370;7876;5506;4832
SP01575;SP;1274;4037;2763;2408
SP01576;SP;1034;4532;3498;3080
SP01577;SP;1023;4405;3382;3022
SP01578;SP;1120;5035;3915;3477
SP01579;SP;811;3634;2823;2463
SP01580;SP;3932;12295;8363;7512
SP01581;SP;1496;5066;3570;3202
SP01582;SP;1386;5360;3974;3565
SP01583;SP;1336;5432;4096;3652
SP01584;SP;976;4414;3438;3032
SP01585;SP;1395;5347;3952;3456
SP01586;SP;1055;4583;3528;3144
SP01587;SP;581;2480;1899;1728
SP01588;SP;1015;4161;3146;2856
SP01589;SP;1138;5101;3963;3565
SP01590;SP;650;2697;2047;1825
SP01591;SP;1048;5257;4209;3840
SP01592;SP;1561;5927;4366;3887
SP01593;SP;899;3907;3008;2696
SP01594;SP;710;3504;2794;2526
SP01595;SP;766;3343;2577;2347
SP01596;SP;746;3064;2318;2075
SP01597;SP;655;2735;2080;1868
SP01598;SP;645;2456;1811;1589
SP01599;SP;1148;4566;3418;3025
SP01600;SP;467;2074;1607;1436
SP01601;SP;241;1244;1003;910
SP01602;SP;1307;5026;3719;3254
SP01603;SP;788;3140;2352;2071
SP01604;SP;573;2213;1640;1458
SP01605;SP;545;2247;1702;1538
SP01606;SP;1133;3909;2776;2467
SP01607;SP;250;1156;906;797
SP01608;SP;581;2455;1874;1669
SP01609;SP;1255;4359;3104;2727
SP01610;SP;784;3105;2321;2039
SP01611;SP;365;1491;1126;1010
SP01612;SP;1388;5316;3928;3541
SP01613;SP;1429;5274;3845;3423
SP01614;SP;1390;5270;3880;3532
SP01615;SP;425;1988;1563;1420
SP01616;SP;1298;5568;4270;3871
SP01617;SP;1705;6274;4569;4003
SP01618;SP;2041;8129;6088;5356
SP01619;SP;1822;6560;4738;4200
SP01620;SP;896;3851;2955;2665
SP01621;SP;1263;5101;3838;3443
SP01622;SP;1105;4052;2947;2631
SP01623;SP;1120;3923;2803;2508
SP01624;SP;2201;7719;5518;4887
SP01625;SP;1195;5942;4747;4257
SP01626;SP;536;2768;2232;1988
SP01627;SP;1594;4603;3009;2680
SP01628;SP;265;974;709;634
SP01629;SP;811;3617;2806;2509
SP01630;SP;417;1721;1304;1174
SP01631;SP;843;3548;2705;2418
SP01632;SP;1796;5894;4098;3675
SP01633;SP;1480;5184;3704;3305
SP01634;SP;364;1387;1023;909
SP01635;SP;1988;6200;4212;3764
SP01636;SP;923;4041;3118;2774
SP01637;SP;339;1545;1206;1069
SP01638;SP;694;2663;1969;1802
SP01639;SP;225;778;553;480
SP01640;SP;573;2145;1572;1444
SP01641;SP;1374;5788;4414;3889
SP01642;SP;672;2330;1658;1478
SP01643;SP;2011;6423;4412;3866
SP01644;SP;1423;6058;4635;4037
SP01645;SP;1277;4193;2916;2634
SP01646;SP;913;4342;3429;3051
SP01647;SP;782;3641;2859;2529
SP01648;SP;1328;5393;4065;3608
SP01649;SP;876;3698;2822;2558
SP01650;SP;318;1635;1317;1202
SP01651;SP;1626;6989;5363;4808
SP01652;SP;1530;5410;3880;3432
SP01653;SP;248;1349;1101;978
SP01654;SP;1317;4908;3591;3246
SP01655;SP;1114;3529;2415;2168
SP01656;SP;1750;5925;4175;3719
SP01657;SP;543;2210;1667;1447
SP01658;SP;1260;4665;3405;2973
SP01659;SP;1025;4975;3950;3495
SP01660;SP;393;1780;1387;1224
SP01661;SP;1356;4921;3565;3170
SP01662;SP;1593;5362;3769;3361
SP01663;SP;1483;4863;3380;2975
SP01664;SP;873;4100;3227;2893
SP01665;SP;885;2933;2048;1790
SP01666;SP;888;3664;2776;2436
SP01667;SP;269;1115;846;727
SP01668;SP;271;1231;960;849
SP01669;SP;302;1414;1112;988
SP01670;SP;523;2365;1842;1624
SP01671;SP;569;2362;1793;1595
SP01672;SP;1134;4183;3049;2696
SP01673;SP;379;1979;1600;1452
SP01674;SP;601;2328;1727;1520
SP01675;SP;1861;7296;5435;4717
SP01676;SP;1649;7202;5553;4710
SP01677;SP;1765;6587;4822;4043
SP01678;SP;1649;6291;4642;4011
SP01679;SP;1361;6584;5223;4527
SP01680;SP;1243;5598;4355;3806
SP01681;SP;1496;6345;4849;4224
SP01682;SP;938;3870;2932;2463
SP01683;SP;1143;4635;3492;3034
SP01684;SP;1207;4928;3721;3261
SP01685;SP;2004;7787;5783;4975
SP01686;SP;1892;7314;5422;4713
SP01687;SP;1112;5072;3960;3519
SP01688;SP;1393;5851;4458;3939
SP01689;SP;1126;4779;3653;3170
SP01690;SP;883;3916;3033;2677
SP01691;SP;1479;6176;4697;3990
SP01692;SP;1662;6368;4706;4084
SP01693;SP;1154;5042;3888;3318
SP01694;SP;1620;6468;4848;4165
SP01695;SP;615;2859;2244;1982
SP01696;SP;866;3501;2635;2243
SP01697;SP;1570;6299;4729;4138
SP01698;SP;814;4270;3456;3054
SP01699;SP;526;2649;2123;1874
SP01700;SP;704;3480;2776;2374
SP01701;SP;1399;5870;4471;3774
SP01702;SP;560;2682;2122;1885
SP01703;SP;504;2290;1786;1562
SP01704;SP;1129;4240;3111;2596
SP01705;SP;443;1680;1237;1072
SP01706;SP;1830;6272;4442;3824
SP01707;SP;1597;5330;3733;3179
SP01708;SP;1145;4897;3752;3155
SP01709;SP;1097;5123;4026;3454
SP01710;SP;1247;4727;3480;2990
SP01711;SP;759;2862;2103;1787
SP01712;SP;781;3629;2848;2560
SP01713;SP;963;4285;3322;2994
SP01714;SP;1024;3989;2965;2626
SP01715;SP;1284;3987;2703;2406
SP01716;SP;830;3015;2185;1978
SP01717;SP;976;3491;2515;2304
SP01718;SP;1671;6133;4462;3987
SP01719;SP;1405;5072;3667;3303
SP01720;SP;1115;4886;3771;3384
SP01721;SP;782;3300;2518;2255
SP01722;SP;1009;4433;3424;3125
SP01723;SP;666;2776;2110;1867
SP01724;SP;1357;5829;4472;4029
SP01725;SP;1576;6477;4901;4313
SP01726;SP;1043;4123;3080;2732
SP01727;SP;1062;4196;3134;2801
SP01728;SP;733;3507;2774;2539
SP01729;SP;955;3858;2903;2597
SP01730;SP;380;1570;1190;1050
SP01731;SP;475;1980;1505;1340
SP01732;SP;1215;5337;4122;3599
SP01733;SP;1384;4951;3567;3222
SP01734;SP;1065;4835;3770;3360
SP01735;SP;644;2431;1787;1584
SP01736;SP;591;2336;1745;1578
SP01737;SP;1501;4533;3032;2672
SP01738;SP;1810;6502;4692;4098
SP01739;SP;1219;4727;3508;3083
SP01740;SP;1260;5160;3900;3385
SP01741;SP;451;2084;1633;1445
SP01742;SP;547;2540;1993;1767
SP01743;SP;1059;4150;3091;2751
SP01744;SP;540;2443;1903;1722
SP01745;SP;1189;3806;2617;2260
SP01746;SP;302;1007;705;598
SP01747;SP;565;2073;1508;1299
SP01748;SP;822;3372;2550;2210
SP01749;SP;841;3518;2677;2397
SP01750;SP;351;1938;1587;1437
SP01751;SP;281;1150;869;775
SP01752;SP;1537;5109;3572;3090
SP01753;SP;1651;5888;4237;3673
SP01754;SP;1407;5351;3944;3468
SP01755;SP;1077;4747;3670;3212
SP01756;SP;1681;6967;5286;4627
SP01757;SP;1493;6189;4696;4141
SP01758;SP;964;4558;3594;3187
SP01759;SP;1210;4843;3633;3235
SP01760;SP;871;3464;2593;2257
SP01761;SP;1589;6449;4860;4313
SP01762;SP;578;1989;1411;1248
SP01763;SP;1450;6217;4767;4196
SP01764;SP;1152;5036;3884;3408
SP01765;SP;905;3450;2545;2215
SP01766;SP;527;2383;1856;1642
SP01767;SP;1570;5732;4162;3641
SP01768;SP;1533;5069;3536;3036
SP01769;SP;1359;4801;3442;3002
SP01770;SP;1697;6174;4477;3954
SP01771;SP;651;2820;2169;1855
SP01772;SP;1737;6424;4687;4023
SP01773;SP;1396;5046;3650;3220
SP01774;SP;754;3149;2395;2084
SP01775;SP;1319;5254;3935;3449
SP01776;SP;1293;5029;3736;3307
SP01777;SP;1116;4580;3464;3071
SP01778;SP;1395;5530;4135;3668
SP01779;SP;725;3173;2448;2155
SP01780;SP;1668;6187;4519;3925
SP01781;SP;945;3570;2625;2281
SP01782;SP;457;1588;1131;964
SP01783;SP;606;2547;1941;1699
SP01784;SP;1390;5548;4158;3576
SP01785;SP;1005;3906;2901;2512
SP01786;SP;1258;5053;3795;3323
SP01787;SP;638;2575;1937;1694
SP01788;SP;1256;4509;3253;2828
SP01789;SP;1575;5960;4385;3822
SP01790;SP;822;3198;2376;2102
SP01791;SP;1537;5115;3578;3098
SP01792;SP;1189;4050;2861;2527
SP01793;SP;1259;3967;2708;2358
SP01794;SP;231;774;543;479
SP01795;SP;815;3220;2405;2149
SP01796;SP;1795;5940;4145;3620
SP01797;SP;1992;6711;4719;4130
SP01798;SP;2025;7205;5180;4589
SP01799;SP;1862;7489;5627;4986
SP01800;SP;2403;8375;5972;5247
SP01801;SP;1173;4591;3418;3027
SP01802;SP;1172;4568;3396;3025
SP01803;SP;1574;6098;4524;3959
SP01804;SP;1623;6591;4968;4370
SP01805;SP;1432;5577;4145;3598
SP01806;SP;1015;4493;3478;3072
SP01807;SP;1153;4489;3336;2891
SP01808;SP;596;2234;1638;1402
SP01809;SP;1132;4775;3643;3256
SP01810;SP;731;2637;1906;1652
SP01811;SP;1702;6412;4710;4128
SP01812;SP;394;1538;1144;1008
SP01813;SP;1288;5173;3885;3381
SP01814;SP;1145;4705;3560;3091
SP01815;SP;897;3249;2352;2037
SP01816;SP;779;3092;2313;2088
SP01817;SP;855;3029;2174;1932
SP01818;SP;235;967;732;620
SP01819;SP;1483;6180;4697;4165
SP01820;SP;2386;8046;5660;5190
SP01821;SP;2173;7786;5613;5020
SP01822;SP;1867;6815;4948;4414
SP01823;SP;2194;7272;5078;4560
SP01824;SP;1103;3725;2622;2323
SP01825;SP;1675;5132;3457;3183
SP01826;SP;1828;6250;4422;4059
SP01827;SP;1938;6711;4773;4275
SP01828;SP;2286;8402;6116;5389
SP01829;SP;1748;6875;5127;4637
SP01830;SP;1090;3740;2650;2388
SP01831;SP;767;3229;2462;2296
SP01832;SP;1643;6225;4582;4102
SP01833;SP;1661;6103;4442;4193
SP01834;SP;296;1138;842;811
SP01835;SP;1633;6616;4983;4450
SP01836;SP;1608;6148;4540;4111
SP01837;SP;772;3345;2573;2300
SP01838;SP;829;3079;2250;2080
SP01839;SP;891;3350;2459;2238
SP01840;SP;616;2311;1695;1528
SP01841;SP;349;1166;817;763
SP01842;SP;1229;5313;4084;3603
SP01843;SP;988;3612;2624;2343
SP01844;SP;1443;4512;3069;2881
SP01845;SP;1851;6584;4733;4177
SP01846;SP;738;3222;2484;2151
SP01847;SP;667;2974;2307;2025
SP01848;SP;675;2632;1957;1782
SP01849;SP;998;3121;2123;1884
SP01850;SP;1059;3510;2451;2328
SP01851;SP;223;982;759;690
SP01852;SP;967;3141;2174;1932
SP01853;SP;715;3021;2306;2167
SP01854;SP;1666;5482;3816;3430
SP01855;SP;1083;3678;2595;2397
SP01856;SP;218;1178;960;914
SP01857;SP;1403;4340;2937;2763
SP01858;SP;2826;8697;5871;5316
SP01859;SP;1849;6287;4438;3946
SP01860;SP;1889;6782;4893;4548
SP01861;SP;1674;5487;3813;3464
SP01862;SP;1366;5013;3647;3272
SP01863;SP;1630;5889;4259;3877
SP01864;SP;1226;4267;3041;2709
SP01865;SP;1395;4732;3337;2993
SP01866;SP;1481;4946;3465;3169
SP01867;SP;1304;5509;4205;3764
SP01868;SP;1018;4200;3182;2905
SP01869;SP;1423;5661;4238;3911
SP01870;SP;1034;4686;3652;3239
SP01871;SP;1817;7738;5921;5197
SP01872;SP;1778;7613;5835;5356
SP01873;SP;665;2770;2105;1967
SP01874;SP;674;2682;2008;1874
SP01875;SP;1202;5494;4292;3842
SP01876;SP;1112;4608;3496;3223
SP01877;SP;1406;5858;4452;3941
SP01878;SP;1387;4970;3583;3182
SP01879;SP;1325;5975;4650;4286
SP01880;SP;1264;4589;3325;2990
SP01881;SP;2037;7339;5302;4766
SP01882;SP;460;1632;1172;1070
SP01883;SP;1315;5157;3842;3431
SP01884;SP;1898;7365;5467;4838
SP01885;SP;393;1800;1407;1256
SP01886;SP;353;1564;1211;1071
SP01887;SP;3487;11149;7662;6846
SP01888;SP;1553;5852;4299;3763
SP01889;SP;2014;7228;5214;4567
SP01890;SP;1522;5322;3800;3386
SP01891;SP;593;2651;2058;1887
SP01892;SP;2287;7589;5302;4747
SP01893;SP;2128;6981;4853;4324
SP01894;SP;1770;7264;5494;4878
SP01895;SP;1102;4468;3366;2992
SP01896;SP;1152;4681;3529;3057
SP01897;SP;845;3517;2672;2338
SP01898;SP;1088;4700;3612;3248
SP01899;SP;1332;6018;4686;4199
SP01900;SP;1158;4988;3830;3470
SP01901;SP;615;2685;2070;1820
SP01902;SP;1022;4700;3678;3245
SP01903;SP;1520;5816;4296;3763
SP01904;SP;2137;6994;4857;4237
SP01905;SP;950;3477;2527;2243
SP01906;SP;1130;4600;3470;3074
SP01907;SP;1200;5356;4156;3684
SP01908;SP;897;3792;2895;2527
SP01909;SP;652;2748;2096;1866
SP01910;SP;437;1968;1531;1356
SP01911;SP;483;1962;1479;1337
SP01912;SP;354;1369;1015;907
SP01913;SP;1208;4665;3457;3054
SP01914;SP;1573;5492;3919;3604
SP01915;SP;1130;3924;2794;2480
SP01916;SP;1864;6631;4767;4250
SP01917;SP;1347;4628;3281;2925
SP01918;SP;1704;5928;4224;3776
SP01919;SP;1618;5480;3862;3455
SP01920;SP;1670;5883;4213;3809
SP01921;SP;1617;5497;3880;3502
SP01922;SP;1219;4328;3109;2851
SP01923;SP;1385;4807;3422;3182
SP01924;SP;1427;5115;3688;3387
SP01925;SP;1389;5445;4056;3777
SP01926;SP;1712;6354;4642;4128
SP01927;SP;1851;6734;4883;4348
SP01928;SP;1372;4314;2942;2560
SP01929;SP;1637;6511;4874;4343
SP01930;SP;1295;4667;3372;2967
SP01931;SP;1366;5097;3731;3305
SP01932;SP;1712;6660;4948;4315
SP01933;SP;1288;4814;3526;3145
SP01934;SP;1913;7848;5935;5331
SP01935;SP;1730;6268;4538;3983
SP01936;SP;1945;7478;5533;4922
SP01937;SP;672;2730;2058;1908
SP01938;SP;1810;7268;5458;4870
SP01939;SP;1772;6689;4917;4310
SP01940;SP;1431;5477;4046;3511
SP01941;SP;1037;3638;2601;2291
SP01942;SP;886;2838;1952;1738
SP01943;SP;1135;3522;2387;2104
SP01944;SP;1268;4146;2878;2532
SP01945;SP;262;778;516;466
SP01946;SP;625;2503;1878;1736
SP01947;SP;397;1722;1325;1234
SP01948;SP;1126;4518;3392;3001
SP01949;SP;1128;4412;3284;2886
SP01950;SP;992;3678;2686;2318
SP01951;SP;776;2720;1944;1676
SP01952;SP;547;1981;1434;1356
SP01953;SP;547;1981;1434;1356
SP01954;SP;642;2478;1836;1674
SP01955;SP;371;1676;1305;1165
SP01956;SP;513;2217;1704;1544
SP01957;SP;1400;4354;2954;2643
SP01958;SP;1478;5003;3525;3167
SP01959;SP;1753;5593;3840;3448
SP01960;SP;1621;5568;3947;3521
SP01961;SP;1748;5779;4031;3594
SP01962;SP;2015;7108;5093;4444
SP01963;SP;1789;6175;4386;3967
SP01964;SP;1516;5289;3773;3393
SP01965;SP;1675;6052;4377;3942
SP01966;SP;1042;3725;2683;2388
SP01967;SP;1295;4971;3676;3360
SP01968;SP;1899;6332;4433;3944
SP01969;SP;1156;4540;3384;3023
SP01970;SP;1274;5176;3902;3479
SP01971;SP;1082;4710;3628;3249
SP01972;SP;1110;4287;3177;2831
SP01973;SP;1283;4606;3323;2955
SP01974;SP;1524;6477;4953;4390
SP01975;SP;694;3160;2466;2263
SP01976;SP;377;1818;1441;1295
SP01977;SP;806;3135;2329;2093
SP01978;SP;467;2051;1584;1405
SP01979;SP;704;3299;2595;2335
SP01980;SP;791;3089;2298;2043
SP01981;SP;874;3490;2616;2355
SP01982;SP;210;971;761;675
SP01983;SP;154;776;622;562
SP01984;SP;396;1613;1217;1076
SP01985;SP;223;977;754;665
SP01986;SP;1768;5859;4091;3592
SP01987;SP;1296;4784;3488;3072
SP01988;SP;1760;5876;4116;3576
SP01989;SP;1648;5992;4344;3833
SP01990;SP;1503;6386;4883;4261
SP01991;SP;1576;6762;5186;4553
SP01992;SP;1917;6492;4575;3970
SP01993;SP;1349;5680;4331;3805
SP01994;SP;1794;8040;6246;5555
SP01995;SP;1384;5916;4532;3938
SP01996;SP;865;4065;3200;2826
SP01997;SP;1678;6927;5249;4642
SP01998;SP;1610;6178;4568;4062
SP01999;SP;1573;6988;5415;4728
SP02000;SP;763;3014;2251;1914
SP02001;SP;739;3226;2487;2109
SP02002;SP;918;3675;2757;2382
SP02003;SP;365;1402;1037;893
SP02004;SP;1208;5152;3944;3453
SP02005;SP;1186;4698;3512;3112
SP02006;SP;664;2512;1848;1651
SP02007;SP;750;2999;2249;1969
SP02008;SP;515;2358;1843;1633
SP02009;SP;675;2652;1977;1690
SP02010;SP;454;1994;1540;1364
SP02011;SP;480;1844;1364;1214
SP02012;SP;271;1265;994;858
SP02013;SP;1733;5458;3725;3224
SP02014;SP;996;3660;2664;2361
SP02015;SP;1968;6390;4422;3805
SP02016;SP;1213;3949;2736;2403
SP02017;SP;1489;5843;4354;3831
SP02018;SP;1519;4910;3391;2913
SP02019;SP;1649;5428;3779;3269
SP02020;SP;1419;5169;3750;3305
SP02021;SP;1074;4916;3842;3403
SP02022;SP;650;2804;2154;1928
SP02023;SP;1727;6925;5198;4568
SP02024;SP;1649;5319;3670;3406
SP02025;SP;1364;4781;3417;3169
SP02026;SP;1848;6348;4500;4105
SP02027;SP;1651;5306;3655;3293
SP02028;SP;2249;7224;4975;4430
SP02029;SP;2086;6908;4822;4236
SP02030;SP;2188;7717;5529;4903
SP02031;SP;1612;5725;4113;3627
SP02032;SP;1658;4842;3184;2874
SP02033;SP;1990;7687;5697;5040
SP02034;SP;1685;6228;4543;3999
SP02035;SP;966;4577;3611;3252
SP02036;SP;897;3622;2725;2505
SP02037;SP;1011;3883;2872;2546
SP02038;SP;1370;5939;4569;4230
SP02039;SP;1688;6572;4884;4336
SP02040;SP;665;2652;1987;1761
SP02041;SP;462;2020;1558;1393
SP02042;SP;813;2852;2039;1891
SP02043;SP;402;1561;1159;1061
SP02044;SP;350;1543;1193;1096
SP02045;SP;500;2296;1796;1622
SP02046;SP;424;1856;1432;1322
SP02047;SP;1232;5031;3799;3379
SP02048;SP;570;2701;2131;1857
SP02049;SP;540;2278;1738;1586
SP02050;SP;840;3558;2718;2454
SP02051;SP;1063;4627;3564;3321
SP02052;SP;1347;4927;3580;3222
SP02053;SP;912;3844;2932;2731
SP02054;SP;600;2287;1687;1502
SP02055;SP;355;1516;1161;1027
SP02056;SP;739;3560;2821;2626
SP02057;SP;790;3114;2324;2086
SP02058;SP;1007;3951;2944;2594
SP02059;SP;17;112;95;79
SP02060;SP;57;285;228;206
SP02061;SP;120;234;114;95
SP02062;SP;38;117;79;75
