CD_LOC;UF;aptos;comparecimentos;abstencoes;validos;votos_cand;pct_validos_local;pct_votos_cand_no_local;pct_votos_local_em_cand
SP00001;SP;10045;6633;3412;6348;2555;40,249;0,144;38,520
SP00002;SP;8476;5539;2937;5301;2300;43,388;0,129;41,524
SP00003;SP;6223;3562;2661;3339;1244;37,257;0,070;34,924
SP00004;SP;6071;4117;1954;3823;1637;42,820;0,092;39,762
SP00005;SP;7574;4851;2723;4540;2076;45,727;0,117;42,795
SP00006;SP;6187;4196;1991;3968;1737;43,775;0,098;41,397
SP00007;SP;9748;5727;4021;5355;2074;38,730;0,117;36,214
SP00008;SP;4250;2710;1540;2536;1183;46,648;0,067;43,653
SP00009;SP;5809;3876;1933;3718;1606;43,195;0,090;41,434
SP00010;SP;9269;6039;3230;5790;2612;45,112;0,147;43,252
SP00011;SP;7822;5249;2573;4994;2634;52,743;0,148;50,181
SP00012;SP;9441;6116;3325;5769;3039;52,678;0,171;49,689
SP00013;SP;4269;2958;1311;2829;1412;49,912;0,079;47,735
SP00014;SP;7153;4433;2720;4097;1480;36,124;0,083;33,386
SP00015;SP;4890;3200;1690;2952;1106;37,466;0,062;34,562
SP00016;SP;4976;3125;1851;2880;931;32,326;0,052;29,792
SP00017;SP;6847;4140;2707;3867;1842;47,634;0,104;44,493
SP00018;SP;5238;3256;1982;3039;1316;43,304;0,074;40,418
SP00019;SP;4798;3546;1252;3411;1589;46,585;0,089;44,811
SP00020;SP;1562;1060;502;990;385;38,889;0,022;36,321
SP00021;SP;3914;2744;1170;2564;973;37,949;0,055;35,459
SP00022;SP;5474;3858;1616;3481;1350;38,782;0,076;34,992
SP00023;SP;2029;1448;581;1349;487;36,101;0,027;33,633
SP00024;SP;629;454;175;432;219;50,694;0,012;48,238
SP00025;SP;3193;2227;966;2126;1206;56,726;0,068;54,154
SP00026;SP;1515;1057;458;991;480;48,436;0,027;45,412
SP00027;SP;3011;1933;1078;1858;833;44,833;0,047;43,094
SP00028;SP;8070;5175;2895;4942;1442;29,178;0,081;27,865
SP00029;SP;17797;12599;5198;12178;4644;38,134;0,261;36,860
SP00030;SP;2911;1924;987;1835;699;38,093;0,039;36,331
SP00031;SP;6412;4268;2144;4024;1500;37,276;0,084;35,145
SP00032;SP;11991;8507;3484;8299;2037;24,545;0,115;23,945
SP00033;SP;7735;5271;2464;4985;2389;47,924;0,134;45,323
SP00034;SP;5401;3246;2155;3075;1173;38,146;0,066;36,137
SP00035;SP;5608;3859;1749;3597;1438;39,978;0,081;37,264
SP00036;SP;6716;4776;1940;4617;1855;40,178;0,104;38,840
SP00037;SP;5446;3922;1524;3788;991;26,162;0,056;25,268
SP00038;SP;8044;5650;2394;5390;1808;33,544;0,102;32,000
SP00039;SP;6391;4336;2055;4105;1286;31,328;0,072;29,659
SP00040;SP;7288;5434;1854;5235;2136;40,802;0,120;39,308
SP00041;SP;4585;3191;1394;3059;1221;39,915;0,069;38,264
SP00042;SP;3797;2921;876;2792;1059;37,930;0,060;36,255
SP00043;SP;3049;2192;857;2077;1112;53,539;0,063;50,730
SP00044;SP;7789;5743;2046;5545;1667;30,063;0,094;29,027
SP00045;SP;3377;2532;845;2413;873;36,179;0,049;34,479
SP00046;SP;8211;6097;2114;5898;1810;30,688;0,102;29,687
SP00047;SP;4672;3348;1324;3176;1392;43,829;0,078;41,577
SP00048;SP;5609;4361;1248;4173;1513;36,257;0,085;34,694
SP00049;SP;2731;2018;713;1963;718;36,577;0,040;35,580
SP00050;SP;1956;1443;513;1402;519;37,019;0,029;35,967
SP00051;SP;9919;6324;3595;6155;2105;34,200;0,118;33,286
SP00052;SP;5165;3133;2032;2935;1251;42,624;0,070;39,930
SP00053;SP;6007;3594;2413;3324;1177;35,409;0,066;32,749
SP00054;SP;5696;3753;1943;3408;1215;35,651;0,068;32,374
SP00055;SP;8226;5391;2835;4961;1811;36,505;0,102;33,593
SP00056;SP;5794;3640;2154;3387;1268;37,437;0,071;34,835
SP00057;SP;4525;2909;1616;2654;653;24,604;0,037;22,448
SP00058;SP;5387;3548;1839;3268;945;28,917;0,053;26,635
SP00059;SP;6072;4040;2032;3728;1176;31,545;0,066;29,109
SP00060;SP;6204;4150;2054;3837;1124;29,294;0,063;27,084
SP00061;SP;5110;3413;1697;3165;841;26,572;0,047;24,641
SP00062;SP;4386;2971;1415;2733;794;29,052;0,045;26,725
SP00063;SP;2961;1817;1144;1694;553;32,645;0,031;30,435
SP00064;SP;6208;4037;2171;3695;1183;32,016;0,067;29,304
SP00065;SP;3705;2327;1378;2080;595;28,606;0,033;25,569
SP00066;SP;2941;1926;1015;1749;439;25,100;0,025;22,793
SP00067;SP;1499;922;577;822;219;26,642;0,012;23,753
SP00068;SP;86;64;22;48;16;33,333;0,001;25,000
SP00069;SP;2939;2032;907;1880;529;28,138;0,030;26,033
SP00070;SP;4221;2997;1224;2825;1108;39,221;0,062;36,970
SP00071;SP;6547;4082;2465;3719;1418;38,129;0,080;34,738
SP00072;SP;4862;3103;1759;2890;1090;37,716;0,061;35,127
SP00073;SP;14871;9817;5054;9320;3431;36,813;0,193;34,950
SP00074;SP;4599;3060;1539;2873;1360;47,337;0,077;44,444
SP00075;SP;2374;1530;844;1409;584;41,448;0,033;38,170
SP00076;SP;7781;5170;2611;4791;1353;28,240;0,076;26,170
SP00077;SP;5316;3714;1602;3401;1100;32,343;0,062;29,618
SP00078;SP;6145;4471;1674;4230;1010;23,877;0,057;22,590
SP00079;SP;6753;5126;1627;4740;1442;30,422;0,081;28,131
SP00080;SP;57;43;14;41;16;39,024;0,001;37,209
SP00081;SP;4985;3194;1791;2956;827;27,977;0,047;25,892
SP00082;SP;2042;1343;699;1244;344;27,653;0,019;25,614
SP00083;SP;12710;9298;3412;8782;2200;25,051;0,124;23,661
SP00084;SP;8514;5960;2554;5561;1469;26,416;0,083;24,648
SP00085;SP;7942;5522;2420;5162;1133;21,949;0,064;20,518
SP00086;SP;5934;4153;1781;3890;848;21,799;0,048;20,419
SP00087;SP;7025;4901;2124;4584;963;21,008;0,054;19,649
SP00088;SP;8110;5666;2444;5310;1056;19,887;0,059;18,637
SP00089;SP;6261;4229;2032;4005;923;23,046;0,052;21,825
SP00090;SP;5982;4272;1710;4069;791;19,440;0,044;18,516
SP00091;SP;6781;4661;2120;4328;873;20,171;0,049;18,730
SP00092;SP;8010;5674;2336;5327;1107;20,781;0,062;19,510
SP00093;SP;4638;3524;1114;3326;653;19,633;0,037;18,530
SP00094;SP;3713;2680;1033;2478;527;21,267;0,030;19,664
SP00095;SP;7262;5378;1884;4963;995;20,048;0,056;18,501
SP00096;SP;3961;2845;1116;2573;517;20,093;0,029;18,172
SP00097;SP;4480;3320;1160;2992;685;22,894;0,039;20,633
SP00098;SP;5038;3701;1337;3346;731;21,847;0,041;19,751
SP00099;SP;4550;3344;1206;3017;644;21,346;0,036;19,258
SP00100;SP;4225;2928;1297;2713;698;25,728;0,039;23,839
SP00101;SP;8957;6780;2177;6355;1529;24,060;0,086;22,552
SP00102;SP;4710;2822;1888;2612;956;36,600;0,054;33,877
SP00103;SP;2478;1733;745;1615;448;27,740;0,025;25,851
SP00104;SP;23;16;7;13;5;38,462;0,000;31,250
SP00105;SP;3570;2330;1240;2269;352;15,513;0,020;15,107
SP00106;SP;4729;3001;1728;2887;715;24,766;0,040;23,825
SP00107;SP;5091;3438;1653;3330;644;19,339;0,036;18,732
SP00108;SP;7706;4996;2710;4834;981;20,294;0,055;19,636
SP00109;SP;3531;2268;1263;2183;423;19,377;0,024;18,651
SP00110;SP;4331;2860;1471;2746;630;22,942;0,035;22,028
SP00111;SP;5405;3713;1692;3600;579;16,083;0,033;15,594
SP00112;SP;5370;3564;1806;3414;818;23,960;0,046;22,952
SP00113;SP;4368;2914;1454;2813;724;25,738;0,041;24,846
SP00114;SP;11524;7280;4244;6980;1466;21,003;0,082;20,137
SP00115;SP;6789;4670;2119;4459;818;18,345;0,046;17,516
SP00116;SP;13458;8809;4649;8500;1940;22,824;0,109;22,023
SP00117;SP;12258;8026;4232;7754;3213;41,437;0,181;40,032
SP00118;SP;11540;7496;4044;7234;3176;43,904;0,179;42,369
SP00119;SP;8699;5629;3070;5431;1178;21,690;0,066;20,927
SP00120;SP;7492;5053;2439;4864;839;17,249;0,047;16,604
SP00121;SP;4046;2658;1388;2521;639;25,347;0,036;24,041
SP00122;SP;2338;1648;690;1597;335;20,977;0,019;20,328
SP00123;SP;2390;1759;631;1701;361;21,223;0,020;20,523
SP00124;SP;5471;3750;1721;3559;1200;33,717;0,068;32,000
SP00125;SP;8768;6055;2713;5776;1883;32,600;0,106;31,098
SP00126;SP;3970;2788;1182;2688;780;29,018;0,044;27,977
SP00127;SP;7300;5121;2179;4900;1563;31,898;0,088;30,521
SP00128;SP;9830;6546;3284;6200;2186;35,258;0,123;33,394
SP00129;SP;8021;5609;2412;5363;1797;33,507;0,101;32,038
SP00130;SP;7718;5325;2393;5106;1628;31,884;0,092;30,573
SP00131;SP;5037;3622;1415;3474;899;25,878;0,051;24,821
SP00132;SP;4938;3378;1560;3204;1014;31,648;0,057;30,018
SP00133;SP;4191;2905;1286;2762;1004;36,350;0,056;34,561
SP00134;SP;5615;3841;1774;3657;1040;28,439;0,059;27,076
SP00135;SP;10099;6853;3246;6392;2124;33,229;0,119;30,994
SP00136;SP;9241;6497;2744;6114;1988;32,516;0,112;30,599
SP00137;SP;6956;4953;2003;4699;1244;26,474;0,070;25,116
SP00138;SP;3114;2129;985;2001;652;32,584;0,037;30,625
SP00139;SP;7945;5514;2431;5139;1505;29,286;0,085;27,294
SP00140;SP;5793;3889;1904;3638;1025;28,175;0,058;26,356
SP00141;SP;4594;3186;1408;2978;756;25,386;0,043;23,729
SP00142;SP;4541;2990;1551;2779;815;29,327;0,046;27,258
SP00143;SP;8101;5686;2415;5354;1329;24,823;0,075;23,373
SP00144;SP;5788;3963;1825;3797;1239;32,631;0,070;31,264
SP00145;SP;4652;3551;1101;3385;755;22,304;0,042;21,262
SP00146;SP;7336;5404;1932;5008;1532;30,591;0,086;28,349
SP00147;SP;7272;5483;1789;5236;1640;31,322;0,092;29,911
SP00148;SP;4985;3706;1279;3480;958;27,529;0,054;25,850
SP00149;SP;3452;2590;862;2382;769;32,284;0,043;29,691
SP00150;SP;2320;1742;578;1690;515;30,473;0,029;29,564
SP00151;SP;4988;3688;1300;3300;1082;32,788;0,061;29,338
SP00152;SP;857;541;316;478;183;38,285;0,010;33,826
SP00153;SP;6503;4705;1798;4168;1505;36,108;0,085;31,987
SP00154;SP;6876;4799;2077;4240;1447;34,127;0,081;30,152
SP00155;SP;6109;4286;1823;3806;1348;35,418;0,076;31,451
SP00156;SP;7080;4869;2211;4246;1570;36,976;0,088;32,245
SP00157;SP;1487;928;559;830;342;41,205;0,019;36,853
SP00158;SP;5902;3987;1915;3548;1378;38,839;0,078;34,562
SP00159;SP;8207;5759;2448;5166;2048;39,644;0,115;35,562
SP00160;SP;7072;5254;1818;4610;1651;35,813;0,093;31,424
SP00161;SP;7454;5453;2001;4797;1819;37,920;0,102;33,358
SP00162;SP;7705;5622;2083;4963;1673;33,709;0,094;29,758
SP00163;SP;6612;4970;1642;4425;1632;36,881;0,092;32,837
SP00164;SP;5864;4364;1500;3867;1462;37,807;0,082;33,501
SP00165;SP;5151;3881;1270;3428;1287;37,544;0,072;33,162
SP00166;SP;3724;2789;935;2473;905;36,595;0,051;32,449
SP00167;SP;6528;4883;1645;4292;1491;34,739;0,084;30,535
SP00168;SP;4204;3050;1154;2777;977;35,182;0,055;32,033
SP00169;SP;6507;4898;1609;4346;1577;36,286;0,089;32,197
SP00170;SP;3660;2732;928;2432;1085;44,613;0,061;39,714
SP00171;SP;6293;4730;1563;4154;1639;39,456;0,092;34,651
SP00172;SP;4627;3517;1110;3151;1257;39,892;0,071;35,741
SP00173;SP;1568;1128;440;1010;425;42,079;0,024;37,677
SP00174;SP;4271;3221;1050;2857;1041;36,437;0,059;32,319
SP00175;SP;4700;3395;1305;2965;1130;38,111;0,064;33,284
SP00176;SP;4725;3530;1195;3165;1176;37,156;0,066;33,314
SP00177;SP;6291;4620;1671;4038;1775;43,957;0,100;38,420
SP00178;SP;8552;6363;2189;5673;2177;38,375;0,122;34,213
SP00179;SP;3023;2176;847;1912;757;39,592;0,043;34,789
SP00180;SP;2715;1992;723;1750;701;40,057;0,039;35,191
SP00181;SP;1188;823;365;726;263;36,226;0,015;31,956
SP00182;SP;780;558;222;495;207;41,818;0,012;37,097
SP00183;SP;1181;745;436;666;269;40,390;0,015;36,107
SP00184;SP;781;570;211;495;195;39,394;0,011;34,211
SP00185;SP;785;570;215;508;227;44,685;0,013;39,825
SP00186;SP;1134;804;330;715;292;40,839;0,016;36,318
SP00187;SP;792;555;237;482;189;39,212;0,011;34,054
SP00188;SP;4302;3191;1111;2827;1027;36,328;0,058;32,184
SP00189;SP;5717;3833;1884;3560;952;26,742;0,054;24,837
SP00190;SP;9191;6215;2976;5844;1321;22,604;0,074;21,255
SP00191;SP;4893;3386;1507;3249;818;25,177;0,046;24,158
SP00192;SP;3326;2267;1059;2144;475;22,155;0,027;20,953
SP00193;SP;4453;3011;1442;2835;696;24,550;0,039;23,115
SP00194;SP;8615;6268;2347;5988;1118;18,671;0,063;17,837
SP00195;SP;3523;2306;1217;2147;638;29,716;0,036;27,667
SP00196;SP;3423;2500;923;2339;569;24,327;0,032;22,760
SP00197;SP;4829;3340;1489;3224;668;20,720;0,038;20,000
SP00198;SP;9846;7057;2789;6645;1341;20,181;0,075;19,002
SP00199;SP;9351;6697;2654;6340;1402;22,114;0,079;20,935
SP00200;SP;4987;3648;1339;3418;730;21,358;0,041;20,011
SP00201;SP;9459;6572;2887;6245;1399;22,402;0,079;21,287
SP00202;SP;7973;5469;2504;5239;1004;19,164;0,056;18,358
SP00203;SP;7005;4837;2168;4575;981;21,443;0,055;20,281
SP00204;SP;4526;3486;1040;3306;689;20,841;0,039;19,765
SP00205;SP;3126;2267;859;2206;530;24,025;0,030;23,379
SP00206;SP;3004;2207;797;2096;435;20,754;0,024;19,710
SP00207;SP;4643;3544;1099;3258;727;22,314;0,041;20,514
SP00208;SP;1780;1279;501;1212;345;28,465;0,019;26,974
SP00209;SP;4117;3042;1075;2916;658;22,565;0,037;21,631
SP00210;SP;2712;2153;559;1998;510;25,526;0,029;23,688
SP00211;SP;6388;4682;1706;4400;833;18,932;0,047;17,792
SP00212;SP;5586;4124;1462;3887;751;19,321;0,042;18,210
SP00213;SP;4732;3454;1278;3206;747;23,300;0,042;21,627
SP00214;SP;5779;4297;1482;3998;1027;25,688;0,058;23,900
SP00215;SP;993;761;232;700;219;31,286;0,012;28,778
SP00216;SP;2036;1558;478;1461;349;23,888;0,020;22,401
SP00217;SP;1566;1244;322;1183;258;21,809;0,015;20,740
SP00218;SP;3583;2575;1008;2405;601;24,990;0,034;23,340
SP00219;SP;5453;3846;1607;3563;856;24,025;0,048;22,257
SP00220;SP;2119;1454;665;1338;340;25,411;0,019;23,384
SP00221;SP;3925;2950;975;2640;715;27,083;0,040;24,237
SP00222;SP;5627;4034;1593;3671;971;26,451;0,055;24,070
SP00223;SP;2666;1909;757;1738;486;27,963;0,027;25,458
SP00224;SP;4682;3295;1387;2987;946;31,671;0,053;28,710
SP00225;SP;4793;3416;1377;3011;1089;36,167;0,061;31,879
SP00226;SP;6504;4681;1823;4140;1189;28,720;0,067;25,401
SP00227;SP;5078;3646;1432;3199;950;29,697;0,053;26,056
SP00228;SP;3772;2679;1093;2329;770;33,061;0,043;28,742
SP00229;SP;6362;4716;1646;4121;1152;27,954;0,065;24,427
SP00230;SP;4442;3139;1303;2770;797;28,773;0,045;25,390
SP00231;SP;4477;3485;992;3112;868;27,892;0,049;24,907
SP00232;SP;6760;5102;1658;4486;1213;27,040;0,068;23,775
SP00233;SP;2180;1518;662;1359;392;28,845;0,022;25,823
SP00234;SP;1126;832;294;745;257;34,497;0,014;30,889
SP00235;SP;6359;4733;1626;4142;1236;29,841;0,070;26,115
SP00236;SP;4570;3488;1082;3132;890;28,416;0,050;25,516
SP00237;SP;4589;3414;1175;3015;835;27,695;0,047;24,458
SP00238;SP;6012;4671;1341;4143;1038;25,054;0,058;22,222
SP00239;SP;5869;4516;1353;3916;1080;27,579;0,061;23,915
SP00240;SP;3251;2449;802;2187;651;29,767;0,037;26,582
SP00241;SP;3798;2913;885;2571;679;26,410;0,038;23,309
SP00242;SP;4031;3017;1014;2629;644;24,496;0,036;21,346
SP00243;SP;3895;2713;1182;2333;594;25,461;0,033;21,895
SP00244;SP;1594;1206;388;1050;285;27,143;0,016;23,632
SP00245;SP;1860;1458;402;1275;346;27,137;0,019;23,731
SP00246;SP;730;578;152;507;152;29,980;0,009;26,298
SP00247;SP;3039;2356;683;2046;531;25,953;0,030;22,538
SP00248;SP;2993;2193;800;1944;520;26,749;0,029;23,712
SP00249;SP;3623;2627;996;2362;607;25,699;0,034;23,106
SP00250;SP;4023;3125;898;2707;748;27,632;0,042;23,936
SP00251;SP;3854;2856;998;2545;692;27,191;0,039;24,230
SP00252;SP;4288;3078;1210;2678;756;28,230;0,043;24,561
SP00253;SP;6617;5105;1512;4447;1233;27,727;0,069;24,153
SP00254;SP;4716;3494;1222;3128;741;23,689;0,042;21,208
SP00255;SP;6778;5044;1734;4539;1226;27,010;0,069;24,306
SP00256;SP;4254;3283;971;2810;938;33,381;0,053;28,571
SP00257;SP;5556;4081;1475;3501;1089;31,105;0,061;26,685
SP00258;SP;2237;1521;716;1287;440;34,188;0,025;28,928
SP00259;SP;1803;1399;404;1245;360;28,916;0,020;25,733
SP00260;SP;6967;4886;2081;4308;1266;29,387;0,071;25,911
SP00261;SP;5727;3983;1744;3595;1129;31,405;0,064;28,345
SP00262;SP;6791;4838;1953;4273;1221;28,575;0,069;25,238
SP00263;SP;10873;8161;2712;7340;2197;29,932;0,124;26,921
SP00264;SP;6606;4757;1849;4115;1173;28,505;0,066;24,658
SP00265;SP;5313;3854;1459;3413;1056;30,941;0,059;27,400
SP00266;SP;6960;5099;1861;4440;1258;28,333;0,071;24,672
SP00267;SP;6197;4417;1780;3869;1148;29,672;0,065;25,990
SP00268;SP;6330;4415;1915;3861;1119;28,982;0,063;25,345
SP00269;SP;4567;3317;1250;2942;852;28,960;0,048;25,686
SP00270;SP;6129;4512;1617;3966;1110;27,988;0,062;24,601
SP00271;SP;6516;4689;1827;4064;1138;28,002;0,064;24,270
SP00272;SP;3513;2773;740;2455;716;29,165;0,040;25,820
SP00273;SP;5615;4390;1225;3838;1114;29,026;0,063;25,376
SP00274;SP;5083;4027;1056;3557;1064;29,913;0,060;26,422
SP00275;SP;4248;3284;964;2908;789;27,132;0,044;24,026
SP00276;SP;4234;3269;965;2855;763;26,725;0,043;23,340
SP00277;SP;4274;3219;1055;2827;805;28,475;0,045;25,008
SP00278;SP;3874;2884;990;2530;768;30,356;0,043;26,630
SP00279;SP;3855;2853;1002;2445;625;25,562;0,035;21,907
SP00280;SP;6493;4855;1638;4191;1180;28,156;0,066;24,305
SP00281;SP;5656;4194;1462;3685;1317;35,739;0,074;31,402
SP00282;SP;6521;4899;1622;4303;1241;28,840;0,070;25,332
SP00283;SP;4282;3227;1055;2830;840;29,682;0,047;26,030
SP00284;SP;4514;3367;1147;2958;915;30,933;0,051;27,176
SP00285;SP;2333;1770;563;1605;470;29,283;0,026;26,554
SP00286;SP;6009;4463;1546;3922;1321;33,682;0,074;29,599
SP00287;SP;1938;1490;448;1314;422;32,116;0,024;28,322
SP00288;SP;2503;1898;605;1633;463;28,353;0,026;24,394
SP00289;SP;3751;2887;864;2482;792;31,910;0,045;27,433
SP00290;SP;2127;1639;488;1462;452;30,917;0,025;27,578
SP00291;SP;43;31;12;28;8;28,571;0,000;25,806
SP00292;SP;3524;2286;1238;2155;561;26,032;0,032;24,541
SP00293;SP;2607;1718;889;1581;415;26,249;0,023;24,156
SP00294;SP;5157;3659;1498;3480;854;24,540;0,048;23,340
SP00295;SP;4636;3029;1607;2813;791;28,119;0,044;26,114
SP00296;SP;2387;1583;804;1489;398;26,729;0,022;25,142
SP00297;SP;1311;946;365;886;212;23,928;0,012;22,410
SP00298;SP;4475;3118;1357;2935;659;22,453;0,037;21,135
SP00299;SP;2182;1568;614;1433;283;19,749;0,016;18,048
SP00300;SP;5119;3795;1324;3534;787;22,269;0,044;20,738
SP00301;SP;3036;2157;879;2025;506;24,988;0,028;23,459
SP00302;SP;5488;4163;1325;3975;731;18,390;0,041;17,559
SP00303;SP;3512;2379;1133;2237;527;23,558;0,030;22,152
SP00304;SP;3481;2524;957;2382;685;28,757;0,039;27,139
SP00305;SP;2904;1801;1103;1686;517;30,664;0,029;28,706
SP00306;SP;5275;3647;1628;3390;785;23,156;0,044;21,525
SP00307;SP;3529;2356;1173;2144;477;22,248;0,027;20,246
SP00308;SP;4601;3237;1364;2869;589;20,530;0,033;18,196
SP00309;SP;3845;2727;1118;2512;592;23,567;0,033;21,709
SP00310;SP;5928;4260;1668;3880;899;23,170;0,051;21,103
SP00311;SP;4745;3212;1533;3053;786;25,745;0,044;24,471
SP00312;SP;3428;2474;954;2317;568;24,514;0,032;22,959
SP00313;SP;5494;4051;1443;3796;1078;28,398;0,061;26,611
SP00314;SP;2699;1861;838;1714;400;23,337;0,023;21,494
SP00315;SP;5861;4276;1585;4036;891;22,076;0,050;20,837
SP00316;SP;8808;6530;2278;6165;1199;19,448;0,067;18,361
SP00317;SP;2042;1501;541;1344;326;24,256;0,018;21,719
SP00318;SP;2552;1822;730;1681;481;28,614;0,027;26,400
SP00319;SP;2366;1775;591;1683;463;27,510;0,026;26,085
SP00320;SP;4504;3135;1369;2925;919;31,419;0,052;29,314
SP00321;SP;4314;3059;1255;2905;774;26,644;0,044;25,302
SP00322;SP;8258;5548;2710;5222;1515;29,012;0,085;27,307
SP00323;SP;4008;2671;1337;2514;713;28,361;0,040;26,694
SP00324;SP;4770;3319;1451;3134;990;31,589;0,056;29,828
SP00325;SP;4286;3094;1192;2933;727;24,787;0,041;23,497
SP00326;SP;3933;2749;1184;2597;774;29,804;0,044;28,156
SP00327;SP;1859;1362;497;1249;274;21,938;0,015;20,117
SP00328;SP;3718;2674;1044;2416;619;25,621;0,035;23,149
SP00329;SP;3347;2208;1139;1978;506;25,581;0,028;22,917
SP00330;SP;4062;2873;1189;2687;638;23,744;0,036;22,207
SP00331;SP;3036;2191;845;2089;477;22,834;0,027;21,771
SP00332;SP;3054;2284;770;2189;456;20,831;0,026;19,965
SP00333;SP;2049;1351;698;1258;302;24,006;0,017;22,354
SP00334;SP;1713;1283;430;1196;304;25,418;0,017;23,694
SP00335;SP;4066;2940;1126;2643;729;27,582;0,041;24,796
SP00336;SP;3224;2282;942;2045;526;25,721;0,030;23,050
SP00337;SP;1495;1118;377;1019;205;20,118;0,012;18,336
SP00338;SP;4592;3124;1468;2890;720;24,913;0,041;23,047
SP00339;SP;3299;2272;1027;2133;527;24,707;0,030;23,195
SP00340;SP;3747;2675;1072;2535;872;34,398;0,049;32,598
SP00341;SP;3178;2297;881;2175;667;30,667;0,038;29,038
SP00342;SP;5123;3662;1461;3456;1008;29,167;0,057;27,526
SP00343;SP;5204;3721;1483;3509;808;23,027;0,045;21,715
SP00344;SP;5849;4118;1731;3908;841;21,520;0,047;20,423
SP00345;SP;7886;5416;2470;5134;1504;29,295;0,085;27,770
SP00346;SP;1595;1205;390;1140;332;29,123;0,019;27,552
SP00347;SP;3164;2342;822;2239;654;29,209;0,037;27,925
SP00348;SP;4643;3365;1278;3144;979;31,139;0,055;29,094
SP00349;SP;3642;2779;863;2498;638;25,540;0,036;22,958
SP00350;SP;1278;961;317;889;311;34,983;0,017;32,362
SP00351;SP;883;686;197;634;171;26,972;0,010;24,927
SP00352;SP;2374;1814;560;1735;376;21,671;0,021;20,728
SP00353;SP;2983;2278;705;2162;744;34,413;0,042;32,660
SP00354;SP;1134;865;269;774;194;25,065;0,011;22,428
SP00355;SP;1892;1470;422;1380;473;34,275;0,027;32,177
SP00356;SP;6871;5190;1681;4952;1152;23,263;0,065;22,197
SP00357;SP;35;23;12;16;10;62,500;0,001;43,478
SP00358;SP;39;25;14;17;9;52,941;0,001;36,000
SP00359;SP;40;30;10;26;12;46,154;0,001;40,000
SP00360;SP;119;106;13;81;40;49,383;0,002;37,736
SP00361;SP;20;12;8;11;11;100,000;0,001;91,667
SP00362;SP;1767;1220;547;1161;277;23,859;0,016;22,705
SP00363;SP;6587;4335;2252;4159;1909;45,900;0,107;44,037
SP00364;SP;1999;1353;646;1290;584;45,271;0,033;43,163
SP00365;SP;5757;3680;2077;3594;589;16,388;0,033;16,005
SP00366;SP;5574;3886;1688;3762;1190;31,632;0,067;30,623
SP00367;SP;3181;2043;1138;1955;709;36,266;0,040;34,704
SP00368;SP;4441;3045;1396;2913;929;31,892;0,052;30,509
SP00369;SP;4203;2956;1247;2893;678;23,436;0,038;22,936
SP00370;SP;7693;5691;2002;5525;1173;21,231;0,066;20,611
SP00371;SP;7513;5272;2241;5094;2205;43,286;0,124;41,825
SP00372;SP;5891;3989;1902;3869;1563;40,398;0,088;39,183
SP00373;SP;5182;3550;1632;3450;1590;46,087;0,089;44,789
SP00374;SP;4011;2670;1341;2595;460;17,726;0,026;17,228
SP00375;SP;4721;3317;1404;3209;1203;37,488;0,068;36,268
SP00376;SP;4805;3354;1451;3222;1409;43,731;0,079;42,010
SP00377;SP;4059;2893;1166;2778;1143;41,145;0,064;39,509
SP00378;SP;3829;2734;1095;2639;746;28,268;0,042;27,286
SP00379;SP;4356;2992;1364;2840;1005;35,387;0,057;33,590
SP00380;SP;4357;2944;1413;2844;1173;41,245;0,066;39,844
SP00381;SP;4728;3340;1388;3209;1397;43,534;0,079;41,826
SP00382;SP;1970;1370;600;1324;615;46,450;0,035;44,891
SP00383;SP;3490;2283;1207;2193;828;37,756;0,047;36,268
SP00384;SP;2769;1971;798;1918;600;31,283;0,034;30,441
SP00385;SP;3955;2825;1130;2691;1040;38,647;0,059;36,814
SP00386;SP;2170;1708;462;1657;693;41,823;0,039;40,574
SP00387;SP;3215;2482;733;2390;903;37,782;0,051;36,382
SP00388;SP;1990;1488;502;1432;707;49,372;0,040;47,513
SP00389;SP;2663;1942;721;1851;843;45,543;0,047;43,409
SP00390;SP;4307;3128;1179;2859;764;26,723;0,043;24,425
SP00391;SP;3539;2437;1102;2238;595;26,586;0,033;24,415
SP00392;SP;4859;3569;1290;3317;802;24,178;0,045;22,471
SP00393;SP;3958;2809;1149;2551;716;28,067;0,040;25,489
SP00394;SP;2651;1853;798;1719;408;23,735;0,023;22,018
SP00395;SP;7319;5036;2283;4565;1163;25,476;0,065;23,094
SP00396;SP;2981;2015;966;1839;396;21,533;0,022;19,653
SP00397;SP;4072;2894;1178;2605;711;27,294;0,040;24,568
SP00398;SP;2787;1796;991;1594;428;26,851;0,024;23,831
SP00399;SP;4200;2969;1231;2734;639;23,372;0,036;21,522
SP00400;SP;2153;1503;650;1380;367;26,594;0,021;24,418
SP00401;SP;6075;4286;1789;3897;1064;27,303;0,060;24,825
SP00402;SP;4338;3200;1138;2895;757;26,149;0,043;23,656
SP00403;SP;6930;5024;1906;4519;1208;26,732;0,068;24,045
SP00404;SP;5256;3768;1488;3374;875;25,934;0,049;23,222
SP00405;SP;4680;3515;1165;3259;832;25,529;0,047;23,670
SP00406;SP;3867;2759;1108;2477;683;27,574;0,038;24,755
SP00407;SP;4191;3035;1156;2687;670;24,935;0,038;22,076
SP00408;SP;7217;5129;2088;4589;1074;23,404;0,060;20,940
SP00409;SP;5537;4146;1391;3675;870;23,673;0,049;20,984
SP00410;SP;1624;1232;392;1111;245;22,052;0,014;19,886
SP00411;SP;1750;1339;411;1214;405;33,361;0,023;30,246
SP00412;SP;2247;1715;532;1566;381;24,330;0,021;22,216
SP00413;SP;5079;3987;1092;3568;876;24,552;0,049;21,971
SP00414;SP;2489;1977;512;1785;473;26,499;0,027;23,925
SP00415;SP;3888;2993;895;2755;691;25,082;0,039;23,087
SP00416;SP;1565;1172;393;1044;265;25,383;0,015;22,611
SP00417;SP;1590;1256;334;1153;331;28,708;0,019;26,354
SP00418;SP;1339;967;372;854;256;29,977;0,014;26,474
SP00419;SP;4961;3484;1477;3249;786;24,192;0,044;22,560
SP00420;SP;1442;1026;416;968;227;23,450;0,013;22,125
SP00421;SP;3048;2181;867;2036;488;23,969;0,027;22,375
SP00422;SP;10320;7595;2725;7125;1862;26,133;0,105;24,516
SP00423;SP;4513;3158;1355;2954;683;23,121;0,038;21,628
SP00424;SP;4823;3449;1374;3189;813;25,494;0,046;23,572
SP00425;SP;6519;4845;1674;4576;761;16,630;0,043;15,707
SP00426;SP;6948;4982;1966;4659;848;18,201;0,048;17,021
SP00427;SP;4605;3414;1191;3208;484;15,087;0,027;14,177
SP00428;SP;5397;3698;1699;3482;621;17,835;0,035;16,793
SP00429;SP;5111;3592;1519;3374;586;17,368;0,033;16,314
SP00430;SP;8129;5971;2158;5673;1174;20,695;0,066;19,662
SP00431;SP;4417;3122;1295;2899;512;17,661;0,029;16,400
SP00432;SP;3964;2754;1210;2526;622;24,624;0,035;22,585
SP00433;SP;4353;3211;1142;3018;696;23,062;0,039;21,675
SP00434;SP;5194;3618;1576;3310;696;21,027;0,039;19,237
SP00435;SP;7037;5280;1757;4887;1081;22,120;0,061;20,473
SP00436;SP;2845;1967;878;1786;382;21,389;0,021;19,420
SP00437;SP;4783;3440;1343;3177;625;19,673;0,035;18,169
SP00438;SP;3263;2333;930;2118;504;23,796;0,028;21,603
SP00439;SP;3746;2751;995;2521;551;21,856;0,031;20,029
SP00440;SP;4147;2940;1207;2666;591;22,168;0,033;20,102
SP00441;SP;4817;3411;1406;3092;572;18,499;0,032;16,769
SP00442;SP;3055;2335;720;2172;547;25,184;0,031;23,426
SP00443;SP;5342;3920;1422;3682;972;26,399;0,055;24,796
SP00444;SP;4038;3031;1007;2821;547;19,390;0,031;18,047
SP00445;SP;2263;1802;461;1650;392;23,758;0,022;21,754
SP00446;SP;7010;5463;1547;5115;976;19,081;0,055;17,866
SP00447;SP;4015;3076;939;2828;769;27,192;0,043;25,000
SP00448;SP;2058;1544;514;1442;429;29,750;0,024;27,785
SP00449;SP;6333;4838;1495;4543;1246;27,427;0,070;25,754
SP00450;SP;4825;3770;1055;3580;761;21,257;0,043;20,186
SP00451;SP;1835;1413;422;1321;362;27,403;0,020;25,619
SP00452;SP;3018;2212;806;2062;606;29,389;0,034;27,396
SP00453;SP;1256;908;348;812;205;25,246;0,012;22,577
SP00454;SP;6000;4085;1915;3686;835;22,653;0,047;20,441
SP00455;SP;4145;2936;1209;2760;543;19,674;0,031;18,495
SP00456;SP;4320;3095;1225;2847;574;20,162;0,032;18,546
SP00457;SP;2816;1940;876;1788;341;19,072;0,019;17,577
SP00458;SP;8529;5970;2559;5467;1069;19,554;0,060;17,906
SP00459;SP;4392;3188;1204;2898;572;19,738;0,032;17,942
SP00460;SP;6386;4591;1795;4172;834;19,990;0,047;18,166
SP00461;SP;4042;2899;1143;2597;554;21,332;0,031;19,110
SP00462;SP;5168;3650;1518;3260;650;19,939;0,037;17,808
SP00463;SP;1010;644;366;588;115;19,558;0,006;17,857
SP00464;SP;4296;3192;1104;2788;562;20,158;0,032;17,607
SP00465;SP;7597;5474;2123;4914;896;18,234;0,050;16,368
SP00466;SP;6038;4389;1649;3941;849;21,543;0,048;19,344
SP00467;SP;5303;3827;1476;3456;806;23,322;0,045;21,061
SP00468;SP;5330;3854;1476;3532;820;23,216;0,046;21,277
SP00469;SP;5448;3854;1594;3537;722;20,413;0,041;18,734
SP00470;SP;4692;3265;1427;3015;673;22,322;0,038;20,613
SP00471;SP;3265;2247;1018;2066;407;19,700;0,023;18,113
SP00472;SP;2507;1806;701;1635;395;24,159;0,022;21,872
SP00473;SP;5477;3996;1481;3679;823;22,370;0,046;20,596
SP00474;SP;5075;3543;1532;3281;748;22,798;0,042;21,112
SP00475;SP;5821;4091;1730;3761;730;19,410;0,041;17,844
SP00476;SP;5975;4311;1664;3973;831;20,916;0,047;19,276
SP00477;SP;2863;2003;860;1826;393;21,522;0,022;19,621
SP00478;SP;3496;2495;1001;2279;524;22,993;0,029;21,002
SP00479;SP;2742;2051;691;1879;432;22,991;0,024;21,063
SP00480;SP;1874;1351;523;1233;287;23,277;0,016;21,244
SP00481;SP;1516;1132;384;1030;240;23,301;0,014;21,201
SP00482;SP;6633;4865;1768;4487;947;21,105;0,053;19,466
SP00483;SP;2523;1867;656;1700;396;23,294;0,022;21,210
SP00484;SP;3212;2384;828;2210;504;22,805;0,028;21,141
SP00485;SP;1466;1071;395;1005;190;18,905;0,011;17,740
SP00486;SP;4286;3178;1108;2834;629;22,195;0,035;19,792
SP00487;SP;2063;1542;521;1356;346;25,516;0,019;22,438
SP00488;SP;1859;1441;418;1316;316;24,012;0,018;21,929
SP00489;SP;1525;1226;299;1114;256;22,980;0,014;20,881
SP00490;SP;1981;1328;653;1190;342;28,739;0,019;25,753
SP00491;SP;985;764;221;713;166;23,282;0,009;21,728
SP00492;SP;847;671;176;610;135;22,131;0,008;20,119
SP00493;SP;1172;862;310;776;186;23,969;0,010;21,578
SP00494;SP;54;32;22;29;24;82,759;0,001;75,000
SP00495;SP;54;40;14;37;15;40,541;0,001;37,500
SP00496;SP;4579;3372;1207;3164;801;25,316;0,045;23,754
SP00497;SP;6925;4935;1990;4614;996;21,586;0,056;20,182
SP00498;SP;3111;2164;947;1973;518;26,254;0,029;23,937
SP00499;SP;6834;4904;1930;4505;1045;23,196;0,059;21,309
SP00500;SP;6586;4736;1850;4227;1121;26,520;0,063;23,670
SP00501;SP;4776;3340;1436;3012;767;25,465;0,043;22,964
SP00502;SP;6808;4910;1898;4479;1049;23,420;0,059;21,365
SP00503;SP;6619;4634;1985;4261;1039;24,384;0,058;22,421
SP00504;SP;4008;3045;963;2772;676;24,387;0,038;22,200
SP00505;SP;2185;1532;653;1412;351;24,858;0,020;22,911
SP00506;SP;4319;3065;1254;2767;702;25,370;0,039;22,904
SP00507;SP;9953;7335;2618;6671;1670;25,034;0,094;22,768
SP00508;SP;5317;3827;1490;3455;919;26,599;0,052;24,014
SP00509;SP;4399;3005;1394;2720;688;25,294;0,039;22,895
SP00510;SP;6209;4329;1880;3841;937;24,395;0,053;21,645
SP00511;SP;6942;4878;2064;4337;1158;26,700;0,065;23,739
SP00512;SP;7389;5163;2226;4594;1138;24,771;0,064;22,041
SP00513;SP;4106;2993;1113;2725;699;25,651;0,039;23,354
SP00514;SP;5514;3990;1524;3648;962;26,371;0,054;24,110
SP00515;SP;4792;3544;1248;3225;792;24,558;0,045;22,348
SP00516;SP;6938;4877;2061;4364;1105;25,321;0,062;22,657
SP00517;SP;3694;2650;1044;2378;624;26,241;0,035;23,547
SP00518;SP;4780;3303;1477;3021;766;25,356;0,043;23,191
SP00519;SP;5846;4121;1725;3726;912;24,477;0,051;22,131
SP00520;SP;3065;2185;880;1962;419;21,356;0,024;19,176
SP00521;SP;5002;3490;1512;3052;739;24,214;0,042;21,175
SP00522;SP;4695;3519;1176;3108;805;25,901;0,045;22,876
SP00523;SP;4290;3229;1061;2820;693;24,574;0,039;21,462
SP00524;SP;2811;2096;715;1907;469;24,594;0,026;22,376
SP00525;SP;5945;4545;1400;4073;1095;26,884;0,062;24,092
SP00526;SP;3210;2393;817;2124;485;22,834;0,027;20,267
SP00527;SP;3105;2475;630;2265;620;27,373;0,035;25,051
SP00528;SP;2366;1777;589;1669;440;26,363;0,025;24,761
SP00529;SP;3155;2369;786;2189;536;24,486;0,030;22,626
SP00530;SP;1521;1164;357;1056;246;23,295;0,014;21,134
SP00531;SP;6972;5267;1705;4741;1161;24,489;0,065;22,043
SP00532;SP;2674;1939;735;1774;487;27,452;0,027;25,116
SP00533;SP;2644;2087;557;1916;586;30,585;0,033;28,079
SP00534;SP;4351;3409;942;3196;796;24,906;0,045;23,350
SP00535;SP;4936;3367;1569;3157;681;21,571;0,038;20,226
SP00536;SP;6329;4580;1749;4200;1090;25,952;0,061;23,799
SP00537;SP;4344;3031;1313;2817;680;24,139;0,038;22,435
SP00538;SP;5278;3612;1666;3264;912;27,941;0,051;25,249
SP00539;SP;5948;4112;1836;3885;885;22,780;0,050;21,522
SP00540;SP;3175;2092;1083;1924;412;21,414;0,023;19,694
SP00541;SP;3175;2092;1083;1924;412;21,414;0,023;19,694
SP00542;SP;4842;3391;1451;3009;719;23,895;0,040;21,203
SP00543;SP;8077;5459;2618;4828;1122;23,239;0,063;20,553
SP00544;SP;5536;3707;1829;3426;762;22,242;0,043;20,556
SP00545;SP;7097;4864;2233;4426;1005;22,707;0,057;20,662
SP00546;SP;4580;3085;1495;2734;668;24,433;0,038;21,653
SP00547;SP;3238;2322;916;2126;443;20,837;0,025;19,078
SP00548;SP;4404;2954;1450;2736;599;21,893;0,034;20,278
SP00549;SP;5928;4010;1918;3711;873;23,525;0,049;21,771
SP00550;SP;4742;3413;1329;3090;616;19,935;0,035;18,049
SP00551;SP;4597;3270;1327;2992;688;22,995;0,039;21,040
SP00552;SP;5887;3978;1909;3593;827;23,017;0,047;20,789
SP00553;SP;4676;3124;1552;2777;668;24,055;0,038;21,383
SP00554;SP;5499;4102;1397;3539;869;24,555;0,049;21,185
SP00555;SP;3492;2514;978;2217;565;25,485;0,032;22,474
SP00556;SP;1967;1498;469;1364;306;22,434;0,017;20,427
SP00557;SP;5966;4380;1586;3869;1047;27,061;0,059;23,904
SP00558;SP;5547;4114;1433;3583;772;21,546;0,043;18,765
SP00559;SP;6869;5121;1748;4487;1210;26,967;0,068;23,628
SP00560;SP;4755;3443;1312;3032;837;27,606;0,047;24,310
SP00561;SP;4720;3508;1212;3096;659;21,286;0,037;18,786
SP00562;SP;3269;2452;817;2249;665;29,569;0,037;27,121
SP00563;SP;3945;2921;1024;2552;570;22,335;0,032;19,514
SP00564;SP;6019;4389;1630;3798;807;21,248;0,045;18,387
SP00565;SP;3148;2356;792;2159;593;27,466;0,033;25,170
SP00566;SP;3965;2993;972;2667;594;22,272;0,033;19,846
SP00567;SP;3964;2865;1099;2677;604;22,563;0,034;21,082
SP00568;SP;4355;3188;1167;3011;685;22,750;0,039;21,487
SP00569;SP;2316;1676;640;1494;353;23,628;0,020;21,062
SP00570;SP;1547;1176;371;1032;243;23,547;0,014;20,663
SP00571;SP;1966;1470;496;1274;358;28,100;0,020;24,354
SP00572;SP;5117;3692;1425;3220;810;25,155;0,046;21,939
SP00573;SP;1187;887;300;778;204;26,221;0,011;22,999
SP00574;SP;4916;3364;1552;2915;863;29,605;0,049;25,654
SP00575;SP;1945;1339;606;1156;307;26,557;0,017;22,928
SP00576;SP;45;45;0;43;2;4,651;0,000;4,444
SP00577;SP;8415;5842;2573;5470;1255;22,943;0,071;21,482
SP00578;SP;2949;2238;711;2075;376;18,120;0,021;16,801
SP00579;SP;4397;3146;1251;2800;1048;37,429;0,059;33,312
SP00580;SP;3133;2253;880;2085;481;23,070;0,027;21,349
SP00581;SP;5307;3773;1534;3511;929;26,460;0,052;24,622
SP00582;SP;4259;3081;1178;2839;700;24,657;0,039;22,720
SP00583;SP;4985;3669;1316;3376;658;19,491;0,037;17,934
SP00584;SP;2542;1782;760;1595;359;22,508;0,020;20,146
SP00585;SP;4746;3318;1428;3055;668;21,866;0,038;20,133
SP00586;SP;2592;1953;639;1811;565;31,198;0,032;28,930
SP00587;SP;3697;2586;1111;2443;434;17,765;0,024;16,783
SP00588;SP;5167;3521;1646;3249;692;21,299;0,039;19,654
SP00589;SP;4702;3299;1403;2945;690;23,430;0,039;20,915
SP00590;SP;7580;5281;2299;4767;1017;21,334;0,057;19,258
SP00591;SP;6263;4400;1863;3968;984;24,798;0,055;22,364
SP00592;SP;5506;4004;1502;3604;915;25,388;0,051;22,852
SP00593;SP;5605;4143;1462;3747;906;24,179;0,051;21,868
SP00594;SP;3522;2548;974;2252;595;26,421;0,033;23,352
SP00595;SP;3557;2586;971;2360;551;23,347;0,031;21,307
SP00596;SP;3534;2596;938;2315;613;26,479;0,034;23,613
SP00597;SP;5301;3798;1503;3363;869;25,840;0,049;22,880
SP00598;SP;4844;3433;1411;3099;669;21,588;0,038;19,487
SP00599;SP;6251;4342;1909;3850;971;25,221;0,055;22,363
SP00600;SP;4185;3069;1116;2750;736;26,764;0,041;23,982
SP00601;SP;6122;4375;1747;4024;1028;25,547;0,058;23,497
SP00602;SP;3850;2848;1002;2612;724;27,718;0,041;25,421
SP00603;SP;4959;3460;1499;3080;764;24,805;0,043;22,081
SP00604;SP;3537;2594;943;2282;699;30,631;0,039;26,947
SP00605;SP;4399;3458;941;3192;718;22,494;0,040;20,763
SP00606;SP;2414;1894;520;1733;323;18,638;0,018;17,054
SP00607;SP;2771;2166;605;1946;448;23,022;0,025;20,683
SP00608;SP;3524;2701;823;2432;606;24,918;0,034;22,436
SP00609;SP;2139;1671;468;1494;353;23,628;0,020;21,125
SP00610;SP;4996;3877;1119;3624;860;23,731;0,048;22,182
SP00611;SP;1902;1499;403;1356;340;25,074;0,019;22,682
SP00612;SP;2164;1540;624;1406;412;29,303;0,023;26,753
SP00613;SP;1184;914;270;823;232;28,190;0,013;25,383
SP00614;SP;6485;4910;1575;4418;1230;27,841;0,069;25,051
SP00615;SP;1062;843;219;746;273;36,595;0,015;32,384
SP00616;SP;3937;3054;883;2837;665;23,440;0,037;21,775
SP00617;SP;1349;956;393;883;212;24,009;0,012;22,176
SP00618;SP;5671;3944;1727;3552;825;23,226;0,046;20,918
SP00619;SP;1692;1227;465;1122;265;23,619;0,015;21,597
SP00620;SP;98;65;33;59;38;64,407;0,002;58,462
SP00621;SP;7468;5058;2410;4865;959;19,712;0,054;18,960
SP00622;SP;8525;5893;2632;5639;1094;19,401;0,062;18,564
SP00623;SP;5777;3983;1794;3816;694;18,187;0,039;17,424
SP00624;SP;6339;4326;2013;4147;814;19,629;0,046;18,816
SP00625;SP;10784;7630;3154;7349;1400;19,050;0,079;18,349
SP00626;SP;6265;4313;1952;4163;787;18,905;0,044;18,247
SP00627;SP;7090;4763;2327;4533;838;18,487;0,047;17,594
SP00628;SP;7913;5698;2215;5552;933;16,805;0,052;16,374
SP00629;SP;3705;2452;1253;2303;516;22,406;0,029;21,044
SP00630;SP;5514;3774;1740;3628;740;20,397;0,042;19,608
SP00631;SP;2522;1571;951;1459;316;21,659;0,018;20,115
SP00632;SP;9851;7134;2717;6837;1340;19,599;0,075;18,783
SP00633;SP;3955;2796;1159;2708;448;16,544;0,025;16,023
SP00634;SP;6679;4545;2134;4327;866;20,014;0,049;19,054
SP00635;SP;5917;4054;1863;3789;905;23,885;0,051;22,324
SP00636;SP;7155;4893;2262;4683;889;18,984;0,050;18,169
SP00637;SP;5885;3783;2102;3611;756;20,936;0,043;19,984
SP00638;SP;6804;4640;2164;4408;1107;25,113;0,062;23,858
SP00639;SP;9027;6272;2755;5998;1257;20,957;0,071;20,041
SP00640;SP;6187;4214;1973;4002;830;20,740;0,047;19,696
SP00641;SP;6983;4703;2280;4445;1068;24,027;0,060;22,709
SP00642;SP;5042;3746;1296;3522;751;21,323;0,042;20,048
SP00643;SP;3354;2459;895;2299;551;23,967;0,031;22,407
SP00644;SP;5516;3931;1585;3760;777;20,665;0,044;19,766
SP00645;SP;3823;2661;1162;2508;478;19,059;0,027;17,963
SP00646;SP;3531;2581;950;2445;559;22,863;0,031;21,658
SP00647;SP;7403;5083;2320;4892;1041;21,280;0,059;20,480
SP00648;SP;3841;2877;964;2733;685;25,064;0,039;23,810
SP00649;SP;2648;1982;666;1879;518;27,568;0,029;26,135
SP00650;SP;4689;3535;1154;3393;648;19,098;0,036;18,331
SP00651;SP;4603;3022;1581;2809;800;28,480;0,045;26,473
SP00652;SP;4711;3356;1355;3082;742;24,075;0,042;22,110
SP00653;SP;9758;6871;2887;6586;1867;28,348;0,105;27,172
SP00654;SP;5621;3951;1670;3772;1038;27,519;0,058;26,272
SP00655;SP;4274;3048;1226;2913;703;24,133;0,040;23,064
SP00656;SP;7540;5423;2117;5139;1383;26,912;0,078;25,502
SP00657;SP;6658;4729;1929;4461;1151;25,801;0,065;24,339
SP00658;SP;4399;3055;1344;2912;866;29,739;0,049;28,347
SP00659;SP;4066;2843;1223;2695;905;33,581;0,051;31,833
SP00660;SP;1900;1365;535;1306;422;32,312;0,024;30,916
SP00661;SP;3498;2295;1203;2116;550;25,992;0,031;23,965
SP00662;SP;4467;3192;1275;3050;786;25,770;0,044;24,624
SP00663;SP;4883;3374;1509;3199;1062;33,198;0,060;31,476
SP00664;SP;4189;2951;1238;2798;683;24,410;0,038;23,145
SP00665;SP;4690;3236;1454;3048;686;22,507;0,039;21,199
SP00666;SP;4794;3234;1560;3039;918;30,207;0,052;28,386
SP00667;SP;7365;5371;1994;5034;1488;29,559;0,084;27,704
SP00668;SP;5384;3806;1578;3593;1178;32,786;0,066;30,951
SP00669;SP;4307;3090;1217;2935;782;26,644;0,044;25,307
SP00670;SP;5766;4219;1547;3993;853;21,362;0,048;20,218
SP00671;SP;7344;4961;2383;4615;1113;24,117;0,063;22,435
SP00672;SP;5404;3859;1545;3618;943;26,064;0,053;24,436
SP00673;SP;3585;2570;1015;2428;534;21,993;0,030;20,778
SP00674;SP;3396;2582;814;2338;619;26,476;0,035;23,974
SP00675;SP;2186;1721;465;1640;379;23,110;0,021;22,022
SP00676;SP;3751;2837;914;2653;532;20,053;0,030;18,752
SP00677;SP;1922;1504;418;1420;395;27,817;0,022;26,263
SP00678;SP;3777;2815;962;2612;729;27,910;0,041;25,897
SP00679;SP;4304;3017;1287;2831;697;24,620;0,039;23,102
SP00680;SP;11486;8694;2792;8233;2232;27,110;0,126;25,673
SP00681;SP;5137;3903;1234;3716;1116;30,032;0,063;28,593
SP00682;SP;2306;1759;547;1678;400;23,838;0,023;22,740
SP00683;SP;5169;3990;1179;3812;1233;32,345;0,069;30,902
SP00684;SP;1542;1148;394;1090;271;24,862;0,015;23,606
SP00685;SP;329;273;56;258;87;33,721;0,005;31,868
SP00686;SP;9715;6586;3129;6066;1638;27,003;0,092;24,871
SP00687;SP;5282;3669;1613;3417;861;25,198;0,048;23,467
SP00688;SP;4013;2804;1209;2605;684;26,257;0,038;24,394
SP00689;SP;6259;4395;1864;4101;1103;26,896;0,062;25,097
SP00690;SP;5510;3819;1691;3562;922;25,884;0,052;24,142
SP00691;SP;2030;1356;674;1262;272;21,553;0,015;20,059
SP00692;SP;8151;5848;2303;5475;1280;23,379;0,072;21,888
SP00693;SP;4634;3251;1383;3010;738;24,518;0,042;22,701
SP00694;SP;8474;6228;2246;5860;1486;25,358;0,084;23,860
SP00695;SP;5738;3934;1804;3659;1015;27,740;0,057;25,801
SP00696;SP;1384;1069;315;1007;303;30,089;0,017;28,344
SP00697;SP;4338;3181;1157;3028;640;21,136;0,036;20,119
SP00698;SP;4269;3022;1247;2750;876;31,855;0,049;28,987
SP00699;SP;2845;1980;865;1799;397;22,068;0,022;20,051
SP00700;SP;2038;1296;742;1203;290;24,106;0,016;22,377
SP00701;SP;4091;3020;1071;2798;620;22,159;0,035;20,530
SP00702;SP;3281;2263;1018;2117;493;23,288;0,028;21,785
SP00703;SP;3713;2640;1073;2382;586;24,601;0,033;22,197
SP00704;SP;5896;4329;1567;3928;1021;25,993;0,057;23,585
SP00705;SP;2464;1689;775;1561;371;23,767;0,021;21,966
SP00706;SP;5478;3976;1502;3593;1011;28,138;0,057;25,428
SP00707;SP;6988;4980;2008;4458;1083;24,293;0,061;21,747
SP00708;SP;5710;3952;1758;3529;925;26,211;0,052;23,406
SP00709;SP;5869;4162;1707;3726;1090;29,254;0,061;26,189
SP00710;SP;3923;2817;1106;2562;555;21,663;0,031;19,702
SP00711;SP;4783;3500;1283;3195;778;24,351;0,044;22,229
SP00712;SP;7054;5112;1942;4635;1150;24,811;0,065;22,496
SP00713;SP;5464;4097;1367;3724;1005;26,987;0,057;24,530
SP00714;SP;3081;2248;833;2021;525;25,977;0,030;23,354
SP00715;SP;4628;3619;1009;3271;825;25,222;0,046;22,796
SP00716;SP;6085;4740;1345;4264;1309;30,699;0,074;27,616
SP00717;SP;5351;4130;1221;3720;1067;28,683;0,060;25,835
SP00718;SP;3625;2512;1113;2242;717;31,980;0,040;28,543
SP00719;SP;6130;4359;1771;3919;1172;29,906;0,066;26,887
SP00720;SP;2043;1618;425;1463;459;31,374;0,026;28,368
SP00721;SP;3054;2197;857;2063;574;27,824;0,032;26,127
SP00722;SP;3108;2416;692;2188;654;29,890;0,037;27,070
SP00723;SP;5496;4095;1401;3699;1133;30,630;0,064;27,668
SP00724;SP;3664;2699;965;2534;547;21,586;0,031;20,267
SP00725;SP;5899;4174;1725;3910;985;25,192;0,055;23,598
SP00726;SP;4468;3025;1443;2809;706;25,133;0,040;23,339
SP00727;SP;5267;3869;1398;3548;928;26,156;0,052;23,986
SP00728;SP;4919;3629;1290;3286;976;29,702;0,055;26,894
SP00729;SP;8105;5929;2176;5377;1620;30,128;0,091;27,323
SP00730;SP;5502;4153;1349;3748;1153;30,763;0,065;27,763
SP00731;SP;4685;3466;1219;3123;935;29,939;0,053;26,976
SP00732;SP;3768;2783;985;2477;808;32,620;0,045;29,033
SP00733;SP;6587;4986;1601;4393;1362;31,004;0,077;27,316
SP00734;SP;3871;2912;959;2590;795;30,695;0,045;27,301
SP00735;SP;5909;4419;1490;4005;1120;27,965;0,063;25,345
SP00736;SP;6501;5079;1422;4565;1272;27,864;0,072;25,044
SP00737;SP;6265;4846;1419;4370;1127;25,789;0,063;23,256
SP00738;SP;8744;6776;1968;6083;2000;32,879;0,113;29,516
SP00739;SP;1868;1437;431;1321;364;27,555;0,020;25,331
SP00740;SP;3936;3068;868;2780;835;30,036;0,047;27,216
SP00741;SP;4300;3373;927;3062;976;31,875;0,055;28,936
SP00742;SP;5088;4001;1087;3633;961;26,452;0,054;24,019
SP00743;SP;4240;3246;994;2959;813;27,475;0,046;25,046
SP00744;SP;5446;4215;1231;3718;1115;29,989;0,063;26,453
SP00745;SP;4714;3481;1233;3283;841;25,617;0,047;24,160
SP00746;SP;1614;1302;312;1194;381;31,910;0,021;29,263
SP00747;SP;4941;3778;1163;3429;1158;33,771;0,065;30,651
SP00748;SP;3624;2591;1033;2384;630;26,426;0,035;24,315
SP00749;SP;1955;1539;416;1379;465;33,720;0,026;30,214
SP00750;SP;1353;1052;301;967;321;33,195;0,018;30,513
SP00751;SP;1977;1546;431;1383;366;26,464;0,021;23,674
SP00752;SP;3263;2381;882;2062;666;32,299;0,037;27,971
SP00753;SP;1731;1380;351;1254;378;30,144;0,021;27,391
SP00754;SP;1139;973;166;913;251;27,492;0,014;25,797
SP00755;SP;2817;2116;701;1899;607;31,964;0,034;28,686
SP00756;SP;3235;2278;957;2048;642;31,348;0,036;28,183
SP00757;SP;3284;2523;761;2281;680;29,811;0,038;26,952
SP00758;SP;4241;3341;900;3016;879;29,145;0,049;26,309
SP00759;SP;3490;2694;796;2390;760;31,799;0,043;28,211
SP00760;SP;6093;4322;1771;3865;1213;31,384;0,068;28,066
SP00761;SP;3317;2430;887;2172;729;33,564;0,041;30,000
SP00762;SP;4199;3275;924;2932;895;30,525;0,050;27,328
SP00763;SP;2894;2276;618;2054;611;29,747;0,034;26,845
SP00764;SP;1319;1062;257;929;327;35,199;0,018;30,791
SP00765;SP;8135;5621;2514;5233;1540;29,429;0,087;27,397
SP00766;SP;7053;4968;2085;4597;1162;25,277;0,065;23,390
SP00767;SP;6440;4457;1983;4149;1131;27,260;0,064;25,376
SP00768;SP;4292;2930;1362;2732;667;24,414;0,038;22,765
SP00769;SP;5078;3464;1614;3221;1005;31,201;0,057;29,013
SP00770;SP;6150;4203;1947;3800;1112;29,263;0,063;26,457
SP00771;SP;7436;5164;2272;4740;1210;25,527;0,068;23,431
SP00772;SP;5664;4117;1547;3665;1051;28,677;0,059;25,528
SP00773;SP;6264;4426;1838;4024;910;22,614;0,051;20,560
SP00774;SP;7854;5792;2062;5286;1265;23,931;0,071;21,840
SP00775;SP;7449;5305;2144;4751;1089;22,921;0,061;20,528
SP00776;SP;6598;4696;1902;4244;1046;24,647;0,059;22,274
SP00777;SP;5853;4038;1815;3544;931;26,270;0,052;23,056
SP00778;SP;7392;5180;2212;4520;1248;27,611;0,070;24,093
SP00779;SP;7813;5789;2024;5103;1407;27,572;0,079;24,305
SP00780;SP;3820;2943;877;2695;601;22,301;0,034;20,421
SP00781;SP;4179;2991;1188;2681;671;25,028;0,038;22,434
SP00782;SP;6626;4932;1694;4346;1218;28,026;0,069;24,696
SP00783;SP;823;584;239;553;159;28,752;0,009;27,226
SP00784;SP;3105;2329;776;2069;500;24,166;0,028;21,468
SP00785;SP;1882;1434;448;1323;367;27,740;0,021;25,593
SP00786;SP;4539;3402;1137;3036;775;25,527;0,044;22,781
SP00787;SP;2366;1797;569;1621;418;25,787;0,024;23,261
SP00788;SP;6979;5171;1808;4448;1353;30,418;0,076;26,165
SP00789;SP;1625;1189;436;1116;327;29,301;0,018;27,502
SP00790;SP;1404;1020;384;951;267;28,076;0,015;26,176
SP00791;SP;1168;863;305;780;197;25,256;0,011;22,827
SP00792;SP;2736;2040;696;1846;498;26,977;0,028;24,412
SP00793;SP;2523;1921;602;1710;450;26,316;0,025;23,425
SP00794;SP;5472;4057;1415;3583;1084;30,254;0,061;26,719
SP00795;SP;5107;3746;1361;3355;1095;32,638;0,062;29,231
SP00796;SP;1001;710;291;634;146;23,028;0,008;20,563
SP00797;SP;3693;2666;1027;2468;719;29,133;0,040;26,969
SP00798;SP;3561;2771;790;2601;724;27,835;0,041;26,128
SP00799;SP;7792;5629;2163;4943;1528;30,912;0,086;27,145
SP00800;SP;5404;4006;1398;3653;1005;27,512;0,057;25,087
SP00801;SP;3726;2817;909;2598;796;30,639;0,045;28,257
SP00802;SP;2293;1707;586;1473;461;31,297;0,026;27,006
SP00803;SP;3495;2525;970;2238;743;33,199;0,042;29,426
SP00804;SP;1445;1087;358;953;366;38,405;0,021;33,671
SP00805;SP;6882;4879;2003;4361;1176;26,966;0,066;24,103
SP00806;SP;5119;3556;1563;3197;753;23,553;0,042;21,175
SP00807;SP;4221;2943;1278;2676;661;24,701;0,037;22,460
SP00808;SP;5967;4362;1605;3995;1004;25,131;0,056;23,017
SP00809;SP;4931;3684;1247;3427;860;25,095;0,048;23,344
SP00810;SP;4312;3025;1287;2756;777;28,193;0,044;25,686
SP00811;SP;4790;3322;1468;3021;810;26,812;0,046;24,383
SP00812;SP;6537;4507;2030;4071;1070;26,283;0,060;23,741
SP00813;SP;5405;3715;1690;3429;995;29,017;0,056;26,783
SP00814;SP;3409;2340;1069;2158;629;29,147;0,035;26,880
SP00815;SP;4827;3371;1456;3069;850;27,696;0,048;25,215
SP00816;SP;4010;2677;1333;2395;723;30,188;0,041;27,008
SP00817;SP;5075;3549;1526;3130;943;30,128;0,053;26,571
SP00818;SP;4699;3648;1051;3260;874;26,810;0,049;23,958
SP00819;SP;1557;1232;325;1117;289;25,873;0,016;23,458
SP00820;SP;2998;2256;742;2080;486;23,365;0,027;21,543
SP00821;SP;3156;2353;803;2159;545;25,243;0,031;23,162
SP00822;SP;1894;1440;454;1305;353;27,050;0,020;24,514
SP00823;SP;2754;2085;669;1908;511;26,782;0,029;24,508
SP00824;SP;5510;4207;1303;3855;1130;29,313;0,064;26,860
SP00825;SP;3960;3079;881;2883;840;29,136;0,047;27,282
SP00826;SP;2231;1737;494;1602;491;30,649;0,028;28,267
SP00827;SP;7530;5704;1826;5280;1579;29,905;0,089;27,682
SP00828;SP;40;36;4;35;28;80,000;0,002;77,778
SP00829;SP;1366;1096;270;1041;223;21,422;0,013;20,347
SP00830;SP;1919;1541;378;1441;328;22,762;0,018;21,285
SP00831;SP;3038;2306;732;2080;563;27,067;0,032;24,415
SP00832;SP;4365;3114;1251;2887;729;25,251;0,041;23,410
SP00833;SP;5058;3636;1422;3313;807;24,359;0,045;22,195
SP00834;SP;3451;2534;917;2371;458;19,317;0,026;18,074
SP00835;SP;4136;2891;1245;2599;668;25,702;0,038;23,106
SP00836;SP;4922;3424;1498;3076;867;28,186;0,049;25,321
SP00837;SP;2272;1787;485;1638;368;22,466;0,021;20,593
SP00838;SP;4893;3681;1212;3293;833;25,296;0,047;22,630
SP00839;SP;942;694;248;645;180;27,907;0,010;25,937
SP00840;SP;990;792;198;731;215;29,412;0,012;27,146
SP00841;SP;6587;5004;1583;4505;1264;28,058;0,071;25,260
SP00842;SP;6278;4306;1972;3842;1055;27,460;0,059;24,501
SP00843;SP;5641;3932;1709;3457;971;28,088;0,055;24,695
SP00844;SP;1541;1163;378;1019;319;31,305;0,018;27,429
SP00845;SP;1830;1419;411;1258;358;28,458;0,020;25,229
SP00846;SP;7352;5299;2053;4594;1502;32,695;0,084;28,345
SP00847;SP;4082;3056;1026;2680;790;29,478;0,044;25,851
SP00848;SP;5251;3634;1617;3215;854;26,563;0,048;23,500
SP00849;SP;3277;2481;796;2227;549;24,652;0,031;22,128
SP00850;SP;5224;3817;1407;3360;878;26,131;0,049;23,002
SP00851;SP;5695;3897;1798;3445;907;26,328;0,051;23,274
SP00852;SP;1783;1336;447;1187;323;27,211;0,018;24,177
SP00853;SP;4081;3040;1041;2702;676;25,019;0,038;22,237
SP00854;SP;6049;4219;1830;3710;990;26,685;0,056;23,465
SP00855;SP;3058;2169;889;1971;463;23,491;0,026;21,346
SP00856;SP;6062;4538;1524;3965;1099;27,718;0,062;24,218
SP00857;SP;3507;2824;683;2520;626;24,841;0,035;22,167
SP00858;SP;6096;4589;1507;4012;1162;28,963;0,065;25,321
SP00859;SP;4366;3337;1029;2989;808;27,032;0,045;24,213
SP00860;SP;3076;2411;665;2167;563;25,981;0,032;23,351
SP00861;SP;3884;2990;894;2527;818;32,370;0,046;27,358
SP00862;SP;4149;3028;1121;2658;696;26,185;0,039;22,985
SP00863;SP;3714;2835;879;2563;651;25,400;0,037;22,963
SP00864;SP;2151;1674;477;1523;374;24,557;0,021;22,342
SP00865;SP;5331;4079;1252;3676;1057;28,754;0,059;25,913
SP00866;SP;2305;1801;504;1597;444;27,802;0,025;24,653
SP00867;SP;2195;1726;469;1512;529;34,987;0,030;30,649
SP00868;SP;4537;3375;1162;2962;931;31,431;0,052;27,585
SP00869;SP;2469;1895;574;1630;503;30,859;0,028;26,544
SP00870;SP;1214;867;347;734;250;34,060;0,014;28,835
SP00871;SP;4180;3171;1009;2752;740;26,890;0,042;23,336
SP00872;SP;4150;2963;1187;2530;786;31,067;0,044;26,527
SP00873;SP;5220;3631;1589;3177;939;29,556;0,053;25,861
SP00874;SP;3637;2753;884;2442;608;24,898;0,034;22,085
SP00875;SP;4489;3490;999;3034;936;30,850;0,053;26,819
SP00876;SP;4758;3686;1072;3209;878;27,361;0,049;23,820
SP00877;SP;2332;1762;570;1564;407;26,023;0,023;23,099
SP00878;SP;4052;3009;1043;2623;676;25,772;0,038;22,466
SP00879;SP;5137;3540;1597;3060;883;28,856;0,050;24,944
SP00880;SP;4156;3214;942;2820;831;29,468;0,047;25,856
SP00881;SP;1173;898;275;802;208;25,935;0,012;23,163
SP00882;SP;1968;1497;471;1289;377;29,247;0,021;25,184
SP00883;SP;1492;1158;334;1013;322;31,787;0,018;27,807
SP00884;SP;6025;4117;1908;3740;1042;27,861;0,059;25,310
SP00885;SP;3760;2696;1064;2397;690;28,786;0,039;25,593
SP00886;SP;3614;2519;1095;2299;618;26,881;0,035;24,534
SP00887;SP;2549;1778;771;1626;394;24,231;0,022;22,160
SP00888;SP;3225;2422;803;2268;617;27,205;0,035;25,475
SP00889;SP;4118;2831;1287;2624;598;22,790;0,034;21,123
SP00890;SP;6506;4670;1836;4310;1146;26,589;0,064;24,540
SP00891;SP;6195;4624;1571;4237;1160;27,378;0,065;25,087
SP00892;SP;4485;3072;1413;2805;708;25,241;0,040;23,047
SP00893;SP;4866;3614;1252;3312;801;24,185;0,045;22,164
SP00894;SP;4335;3134;1201;2930;812;27,713;0,046;25,909
SP00895;SP;4545;3059;1486;2771;754;27,210;0,042;24,649
SP00896;SP;3683;2558;1125;2297;647;28,167;0,036;25,293
SP00897;SP;4232;3120;1112;2793;749;26,817;0,042;24,006
SP00898;SP;4477;3114;1363;2828;713;25,212;0,040;22,897
SP00899;SP;3360;2430;930;2284;551;24,124;0,031;22,675
SP00900;SP;4799;3561;1238;3150;860;27,302;0,048;24,151
SP00901;SP;4411;3185;1226;2788;893;32,030;0,050;28,038
SP00902;SP;3771;2901;870;2611;789;30,218;0,044;27,198
SP00903;SP;1833;1397;436;1304;370;28,374;0,021;26,485
SP00904;SP;1355;1053;302;957;229;23,929;0,013;21,747
SP00905;SP;5577;4262;1315;3813;1196;31,366;0,067;28,062
SP00906;SP;1659;1267;392;1151;314;27,281;0,018;24,783
SP00907;SP;3598;2756;842;2451;705;28,764;0,040;25,581
SP00908;SP;2080;1573;507;1408;424;30,114;0,024;26,955
SP00909;SP;2198;1652;546;1520;400;26,316;0,023;24,213
SP00910;SP;884;714;170;669;149;22,272;0,008;20,868
SP00911;SP;2895;2154;741;1990;581;29,196;0,033;26,973
SP00912;SP;2322;1799;523;1669;516;30,917;0,029;28,683
SP00913;SP;3776;2897;879;2522;825;32,712;0,046;28,478
SP00914;SP;1086;870;216;777;270;34,749;0,015;31,034
SP00915;SP;1861;1401;460;1239;373;30,105;0,021;26,624
SP00916;SP;1311;995;316;879;288;32,765;0,016;28,945
SP00917;SP;310;246;64;227;92;40,529;0,005;37,398
SP00918;SP;1646;1272;374;1131;315;27,851;0,018;24,764
SP00919;SP;1249;996;253;881;272;30,874;0,015;27,309
SP00920;SP;6672;4828;1844;4222;1598;37,849;0,090;33,099
SP00921;SP;1221;862;359;749;297;39,653;0,017;34,455
SP00922;SP;8638;6089;2549;5400;1574;29,148;0,089;25,850
SP00923;SP;5779;3898;1881;3490;986;28,252;0,055;25,295
SP00924;SP;5898;4232;1666;3763;1136;30,189;0,064;26,843
SP00925;SP;5327;3864;1463;3431;950;27,689;0,053;24,586
SP00926;SP;5575;3935;1640;3541;998;28,184;0,056;25,362
SP00927;SP;4583;3288;1295;3004;823;27,397;0,046;25,030
SP00928;SP;5132;3949;1183;3568;934;26,177;0,053;23,652
SP00929;SP;2588;2013;575;1811;465;25,676;0,026;23,100
SP00930;SP;2858;2200;658;1961;569;29,016;0,032;25,864
SP00931;SP;1575;1220;355;1128;312;27,660;0,018;25,574
SP00932;SP;3504;2674;830;2297;629;27,384;0,035;23,523
SP00933;SP;6037;4261;1776;3866;1460;37,765;0,082;34,264
SP00934;SP;5284;3737;1547;3355;1159;34,545;0,065;31,014
SP00935;SP;6922;4974;1948;4453;1513;33,977;0,085;30,418
SP00936;SP;6913;5008;1905;4417;1528;34,594;0,086;30,511
SP00937;SP;5631;4138;1493;3702;1297;35,035;0,073;31,344
SP00938;SP;7741;5514;2227;4913;1624;33,055;0,091;29,452
SP00939;SP;6851;5005;1846;4527;1324;29,247;0,074;26,454
SP00940;SP;7378;5137;2241;4531;1686;37,210;0,095;32,821
SP00941;SP;8289;6027;2262;5363;1848;34,458;0,104;30,662
SP00942;SP;6510;5027;1483;4496;1354;30,116;0,076;26,935
SP00943;SP;5578;4080;1498;3623;1212;33,453;0,068;29,706
SP00944;SP;6614;4784;1830;4198;1666;39,686;0,094;34,824
SP00945;SP;6631;4923;1708;4415;1415;32,050;0,080;28,743
SP00946;SP;4553;3449;1104;3030;1143;37,723;0,064;33,140
SP00947;SP;6568;4904;1664;4308;1516;35,190;0,085;30,914
SP00948;SP;6371;4901;1470;4307;1598;37,102;0,090;32,606
SP00949;SP;6028;4426;1602;3908;1399;35,798;0,079;31,609
SP00950;SP;6838;5137;1701;4549;1455;31,985;0,082;28,324
SP00951;SP;6758;5122;1636;4527;1707;37,707;0,096;33,327
SP00952;SP;13315;8912;4403;8050;2834;35,205;0,159;31,800
SP00953;SP;6513;4880;1633;4404;1377;31,267;0,077;28,217
SP00954;SP;4954;3697;1257;3284;1088;33,130;0,061;29,429
SP00955;SP;4285;3238;1047;2944;992;33,696;0,056;30,636
SP00956;SP;6086;4211;1875;3805;1264;33,219;0,071;30,017
SP00957;SP;6423;4747;1676;4224;1528;36,174;0,086;32,189
SP00958;SP;5350;3284;2066;2978;1028;34,520;0,058;31,303
SP00959;SP;7126;5108;2018;4526;1835;40,544;0,103;35,924
SP00960;SP;3791;2748;1043;2473;995;40,235;0,056;36,208
SP00961;SP;1021;668;353;580;220;37,931;0,012;32,934
SP00962;SP;709;496;213;418;160;38,278;0,009;32,258
SP00963;SP;706;535;171;491;159;32,383;0,009;29,720
SP00964;SP;11909;8036;3873;7711;1486;19,271;0,084;18,492
SP00965;SP;6230;4373;1857;4089;1035;25,312;0,058;23,668
SP00966;SP;4337;2920;1417;2684;719;26,788;0,040;24,623
SP00967;SP;4335;3041;1294;2783;785;28,207;0,044;25,814
SP00968;SP;5544;3913;1631;3628;992;27,343;0,056;25,351
SP00969;SP;5494;3865;1629;3460;1091;31,532;0,061;28,228
SP00970;SP;4314;2956;1358;2794;914;32,713;0,051;30,920
SP00971;SP;4461;3050;1411;2866;959;33,461;0,054;31,443
SP00972;SP;5527;3750;1777;3495;896;25,637;0,050;23,893
SP00973;SP;4361;3051;1310;2852;664;23,282;0,037;21,763
SP00974;SP;3974;2884;1090;2747;589;21,442;0,033;20,423
SP00975;SP;5925;4068;1857;3742;1053;28,140;0,059;25,885
SP00976;SP;3374;2549;825;2424;661;27,269;0,037;25,932
SP00977;SP;4747;3316;1431;3042;867;28,501;0,049;26,146
SP00978;SP;4720;3350;1370;3145;811;25,787;0,046;24,209
SP00979;SP;3936;2939;997;2696;740;27,448;0,042;25,179
SP00980;SP;4362;2972;1390;2847;381;13,383;0,021;12,820
SP00981;SP;4660;3036;1624;2891;934;32,307;0,053;30,764
SP00982;SP;5546;3870;1676;3645;664;18,217;0,037;17,158
SP00983;SP;4483;3313;1170;3052;750;24,574;0,042;22,638
SP00984;SP;2369;1753;616;1631;512;31,392;0,029;29,207
SP00985;SP;3154;2348;806;2167;668;30,826;0,038;28,450
SP00986;SP;2746;2085;661;1909;578;30,278;0,033;27,722
SP00987;SP;4690;3435;1255;3001;1135;37,821;0,064;33,042
SP00988;SP;5130;3838;1292;3609;1129;31,283;0,064;29,416
SP00989;SP;4732;3471;1261;3218;943;29,304;0,053;27,168
SP00990;SP;3164;2358;806;2177;726;33,349;0,041;30,789
SP00991;SP;3538;2527;1011;2349;568;24,181;0,032;22,477
SP00992;SP;1966;1511;455;1364;481;35,264;0,027;31,833
SP00993;SP;1554;1200;354;1064;384;36,090;0,022;32,000
SP00994;SP;3170;2321;849;2174;480;22,079;0,027;20,681
SP00995;SP;3591;2721;870;2600;572;22,000;0,032;21,022
SP00996;SP;1564;1161;403;1073;364;33,924;0,020;31,352
SP00997;SP;391;285;106;270;93;34,444;0,005;32,632
SP00998;SP;790;578;212;547;184;33,638;0,010;31,834
SP00999;SP;789;574;215;505;205;40,594;0,012;35,714
SP01000;SP;5650;4018;1632;3735;1143;30,602;0,064;28,447
SP01001;SP;5804;4098;1706;3866;1839;47,569;0,103;44,876
SP01002;SP;3956;2855;1101;2616;1058;40,443;0,060;37,058
SP01003;SP;6014;4523;1491;4285;2055;47,958;0,116;45,434
SP01004;SP;8670;6136;2534;5801;2231;38,459;0,126;36,359
SP01005;SP;5082;3418;1664;3224;1267;39,299;0,071;37,068
SP01006;SP;5115;3831;1284;3584;1324;36,942;0,074;34,560
SP01007;SP;3314;2392;922;2193;737;33,607;0,041;30,811
SP01008;SP;3674;2717;957;2485;638;25,674;0,036;23,482
SP01009;SP;3257;2457;800;2274;550;24,186;0,031;22,385
SP01010;SP;2767;2011;756;1872;430;22,970;0,024;21,382
SP01011;SP;4250;3139;1111;2863;687;23,996;0,039;21,886
SP01012;SP;9040;6338;2702;5836;1402;24,023;0,079;22,121
SP01013;SP;5581;4094;1487;3693;895;24,235;0,050;21,861
SP01014;SP;3487;2551;936;2279;579;25,406;0,033;22,697
SP01015;SP;5212;3695;1517;3352;725;21,629;0,041;19,621
SP01016;SP;7681;5440;2241;4737;1297;27,380;0,073;23,842
SP01017;SP;3849;2621;1228;2330;611;26,223;0,034;23,312
SP01018;SP;4200;2913;1287;2584;703;27,206;0,040;24,133
SP01019;SP;3579;2715;864;2443;644;26,361;0,036;23,720
SP01020;SP;1678;1325;353;1185;287;24,219;0,016;21,660
SP01021;SP;5856;4048;1808;3596;913;25,389;0,051;22,554
SP01022;SP;7237;5347;1890;4866;1074;22,072;0,060;20,086
SP01023;SP;5047;3502;1545;3139;807;25,709;0,045;23,044
SP01024;SP;1053;748;305;677;163;24,077;0,009;21,791
SP01025;SP;3899;2743;1156;2497;646;25,871;0,036;23,551
SP01026;SP;4576;3267;1309;2914;744;25,532;0,042;22,773
SP01027;SP;3926;2963;963;2647;724;27,352;0,041;24,435
SP01028;SP;4443;3184;1259;2856;774;27,101;0,044;24,309
SP01029;SP;3145;2379;766;2102;489;23,264;0,028;20,555
SP01030;SP;3473;2728;745;2458;602;24,491;0,034;22,067
SP01031;SP;4290;3312;978;2976;772;25,941;0,043;23,309
SP01032;SP;4988;3787;1201;3368;768;22,803;0,043;20,280
SP01033;SP;4681;3640;1041;3260;703;21,564;0,040;19,313
SP01034;SP;3909;2923;986;2629;545;20,730;0,031;18,645
SP01035;SP;6691;4957;1734;4461;1081;24,232;0,061;21,808
SP01036;SP;4224;3283;941;2981;866;29,051;0,049;26,378
SP01037;SP;5057;3801;1256;3358;752;22,394;0,042;19,784
SP01038;SP;3517;2693;824;2413;587;24,327;0,033;21,797
SP01039;SP;3823;2910;913;2500;789;31,560;0,044;27,113
SP01040;SP;3542;2624;918;2341;429;18,326;0,024;16,349
SP01041;SP;1390;1045;345;952;237;24,895;0,013;22,679
SP01042;SP;4324;3222;1102;2860;728;25,455;0,041;22,595
SP01043;SP;1572;1215;357;1076;258;23,978;0,015;21,235
SP01044;SP;4726;3643;1083;3278;795;24,253;0,045;21,823
SP01045;SP;4702;3558;1144;3198;984;30,769;0,055;27,656
SP01046;SP;1567;1208;359;1075;260;24,186;0,015;21,523
SP01047;SP;2728;2106;622;1848;466;25,216;0,026;22,127
SP01048;SP;1647;1281;366;1151;287;24,935;0,016;22,404
SP01049;SP;2385;1831;554;1631;521;31,944;0,029;28,454
SP01050;SP;1959;1503;456;1357;379;27,929;0,021;25,216
SP01051;SP;3156;2436;720;2170;612;28,203;0,034;25,123
SP01052;SP;6139;4367;1772;4009;855;21,327;0,048;19,579
SP01053;SP;5114;3307;1807;2985;642;21,508;0,036;19,413
SP01054;SP;4275;2952;1323;2664;567;21,284;0,032;19,207
SP01055;SP;5802;4170;1632;3743;842;22,495;0,047;20,192
SP01056;SP;6196;4361;1835;3971;917;23,092;0,052;21,027
SP01057;SP;6658;5029;1629;4626;915;19,780;0,051;18,194
SP01058;SP;5074;3597;1477;3244;603;18,588;0,034;16,764
SP01059;SP;5785;4403;1382;4017;831;20,687;0,047;18,873
SP01060;SP;5345;3929;1416;3593;724;20,150;0,041;18,427
SP01061;SP;4129;2950;1179;2642;537;20,326;0,030;18,203
SP01062;SP;2994;2078;916;1898;410;21,602;0,023;19,731
SP01063;SP;4282;3023;1259;2611;563;21,563;0,032;18,624
SP01064;SP;6076;4508;1568;3996;894;22,372;0,050;19,831
SP01065;SP;3662;2656;1006;2404;520;21,631;0,029;19,578
SP01066;SP;2883;2142;741;1974;377;19,098;0,021;17,600
SP01067;SP;3428;2676;752;2356;496;21,053;0,028;18,535
SP01068;SP;3742;2791;951;2446;587;23,998;0,033;21,032
SP01069;SP;3158;2498;660;2322;443;19,078;0,025;17,734
SP01070;SP;3112;2381;731;2167;443;20,443;0,025;18,606
SP01071;SP;1661;1297;364;1161;263;22,653;0,015;20,278
SP01072;SP;1029;793;236;718;133;18,524;0,007;16,772
SP01073;SP;2744;2141;603;1959;452;23,073;0,025;21,112
SP01074;SP;1372;1070;302;929;225;24,220;0,013;21,028
SP01075;SP;1334;1007;327;906;228;25,166;0,013;22,642
SP01076;SP;3137;2436;701;2236;479;21,422;0,027;19,663
SP01077;SP;3176;2582;594;2426;520;21,434;0,029;20,139
SP01078;SP;10615;7516;3099;6696;1487;22,207;0,084;19,784
SP01079;SP;8588;6157;2431;5426;1365;25,157;0,077;22,170
SP01080;SP;3811;2747;1064;2413;623;25,818;0,035;22,679
SP01081;SP;4604;3442;1162;3068;836;27,249;0,047;24,288
SP01082;SP;2526;1599;927;1391;347;24,946;0,020;21,701
SP01083;SP;3114;2088;1026;1885;445;23,607;0,025;21,312
SP01084;SP;4187;3316;871;2955;660;22,335;0,037;19,903
SP01085;SP;3957;3131;826;2778;688;24,766;0,039;21,974
SP01086;SP;4668;3625;1043;3209;729;22,717;0,041;20,110
SP01087;SP;3331;2631;700;2370;604;25,485;0,034;22,957
SP01088;SP;889;723;166;650;186;28,615;0,010;25,726
SP01089;SP;5551;4240;1311;3833;878;22,906;0,049;20,708
SP01090;SP;4652;3593;1059;3177;789;24,835;0,044;21,959
SP01091;SP;3433;2756;677;2417;651;26,934;0,037;23,621
SP01092;SP;5885;3837;2048;3441;853;24,789;0,048;22,231
SP01093;SP;5944;4192;1752;3769;1010;26,798;0,057;24,094
SP01094;SP;4951;3460;1491;3166;631;19,931;0,035;18,237
SP01095;SP;5974;4274;1700;3803;877;23,061;0,049;20,519
SP01096;SP;4179;2929;1250;2634;600;22,779;0,034;20,485
SP01097;SP;7641;5404;2237;4956;1274;25,706;0,072;23,575
SP01098;SP;5642;4016;1626;3697;951;25,724;0,054;23,680
SP01099;SP;4340;3039;1301;2757;564;20,457;0,032;18,559
SP01100;SP;4090;2819;1271;2551;587;23,011;0,033;20,823
SP01101;SP;5144;3574;1570;3269;851;26,032;0,048;23,811
SP01102;SP;3065;2033;1032;1847;400;21,657;0,023;19,675
SP01103;SP;5564;4101;1463;3810;895;23,491;0,050;21,824
SP01104;SP;3373;2250;1123;1976;456;23,077;0,026;20,267
SP01105;SP;5682;4024;1658;3674;846;23,027;0,048;21,024
SP01106;SP;8626;6096;2530;5278;1210;22,925;0,068;19,849
SP01107;SP;8910;6337;2573;5490;1472;26,812;0,083;23,229
SP01108;SP;3363;2567;796;2290;568;24,803;0,032;22,127
SP01109;SP;3179;2360;819;1990;533;26,784;0,030;22,585
SP01110;SP;3484;2522;962;2225;656;29,483;0,037;26,011
SP01111;SP;1699;1262;437;1137;300;26,385;0,017;23,772
SP01112;SP;1834;1371;463;1176;251;21,344;0,014;18,308
SP01113;SP;5153;3920;1233;3592;840;23,385;0,047;21,429
SP01114;SP;1783;1414;369;1292;324;25,077;0,018;22,914
SP01115;SP;2032;1606;426;1452;405;27,893;0,023;25,218
SP01116;SP;3795;3002;793;2819;813;28,840;0,046;27,082
SP01117;SP;703;507;196;446;116;26,009;0,007;22,880
SP01118;SP;3117;2195;922;1941;572;29,469;0,032;26,059
SP01119;SP;893;706;187;619;166;26,817;0,009;23,513
SP01120;SP;6954;4897;2057;4262;1248;29,282;0,070;25,485
SP01121;SP;2241;1669;572;1464;434;29,645;0,024;26,004
SP01122;SP;3123;2007;1116;1734;579;33,391;0,033;28,849
SP01123;SP;8211;5806;2405;5143;1325;25,763;0,075;22,821
SP01124;SP;6479;4476;2003;3881;1118;28,807;0,063;24,978
SP01125;SP;3476;2517;959;2221;639;28,771;0,036;25,387
SP01126;SP;6161;4278;1883;3867;824;21,309;0,046;19,261
SP01127;SP;7942;5676;2266;5033;1438;28,571;0,081;25,335
SP01128;SP;4920;3469;1451;3124;790;25,288;0,044;22,773
SP01129;SP;6181;4505;1676;3991;1139;28,539;0,064;25,283
SP01130;SP;6066;4251;1815;3803;1005;26,427;0,057;23,641
SP01131;SP;5996;4609;1387;4098;1114;27,184;0,063;24,170
SP01132;SP;5881;4069;1812;3658;821;22,444;0,046;20,177
SP01133;SP;5893;4168;1725;3716;934;25,135;0,053;22,409
SP01134;SP;4563;3326;1237;2951;675;22,874;0,038;20,295
SP01135;SP;5468;3955;1513;3502;940;26,842;0,053;23,767
SP01136;SP;6560;4999;1561;4443;1121;25,231;0,063;22,424
SP01137;SP;1190;902;288;820;199;24,268;0,011;22,062
SP01138;SP;3414;2601;813;2336;643;27,526;0,036;24,721
SP01139;SP;2703;2011;692;1760;459;26,080;0,026;22,824
SP01140;SP;4702;3629;1073;3277;845;25,786;0,048;23,285
SP01141;SP;6662;5002;1660;4489;1010;22,499;0,057;20,192
SP01142;SP;5011;3854;1157;3443;958;27,825;0,054;24,857
SP01143;SP;3097;2339;758;2118;432;20,397;0,024;18,469
SP01144;SP;3086;2381;705;2105;569;27,031;0,032;23,898
SP01145;SP;5008;3768;1240;3282;929;28,306;0,052;24,655
SP01146;SP;4300;3212;1088;2836;717;25,282;0,040;22,323
SP01147;SP;2332;1719;613;1550;398;25,677;0,022;23,153
SP01148;SP;2683;2057;626;1794;504;28,094;0,028;24,502
SP01149;SP;3540;2733;807;2503;567;22,653;0,032;20,746
SP01150;SP;1851;1423;428;1249;390;31,225;0,022;27,407
SP01151;SP;692;530;162;462;135;29,221;0,008;25,472
SP01152;SP;1143;876;267;777;211;27,156;0,012;24,087
SP01153;SP;12021;8675;3346;7543;2159;28,623;0,121;24,888
SP01154;SP;7187;5411;1776;4666;1402;30,047;0,079;25,910
SP01155;SP;4827;3705;1122;3216;1001;31,126;0,056;27,018
SP01156;SP;4593;3443;1150;3002;889;29,614;0,050;25,821
SP01157;SP;6773;5060;1713;4423;1245;28,148;0,070;24,605
SP01158;SP;6016;4357;1659;3746;1356;36,199;0,076;31,122
SP01159;SP;2758;2109;649;1825;590;32,329;0,033;27,975
SP01160;SP;1821;1402;419;1184;423;35,726;0,024;30,171
SP01161;SP;2722;2141;581;1875;623;33,227;0,035;29,099
SP01162;SP;1286;971;315;845;241;28,521;0,014;24,820
SP01163;SP;4114;2788;1326;2511;610;24,293;0,034;21,879
SP01164;SP;5708;3888;1820;3510;887;25,271;0,050;22,814
SP01165;SP;3908;2796;1112;2560;618;24,141;0,035;22,103
SP01166;SP;5277;3758;1519;3330;970;29,129;0,055;25,812
SP01167;SP;6259;4450;1809;3857;1132;29,349;0,064;25,438
SP01168;SP;5911;4089;1822;3706;1012;27,307;0,057;24,749
SP01169;SP;6535;4709;1826;4207;953;22,653;0,054;20,238
SP01170;SP;7817;5560;2257;4925;1551;31,492;0,087;27,896
SP01171;SP;6620;4759;1861;4198;1245;29,657;0,070;26,161
SP01172;SP;6690;4889;1801;4508;927;20,563;0,052;18,961
SP01173;SP;4537;3315;1222;2967;770;25,952;0,043;23,228
SP01174;SP;6350;4434;1916;3921;991;25,274;0,056;22,350
SP01175;SP;4660;3409;1251;3034;676;22,281;0,038;19,830
SP01176;SP;8236;5751;2485;5001;1389;27,774;0,078;24,152
SP01177;SP;4264;3029;1235;2761;638;23,108;0,036;21,063
SP01178;SP;7018;4887;2131;4217;1312;31,112;0,074;26,847
SP01179;SP;3692;2867;825;2584;654;25,310;0,037;22,811
SP01180;SP;4666;3372;1294;2916;862;29,561;0,048;25,563
SP01181;SP;4741;3452;1289;3075;815;26,504;0,046;23,610
SP01182;SP;5929;4415;1514;4150;875;21,084;0,049;19,819
SP01183;SP;6376;4658;1718;4337;1120;25,824;0,063;24,045
SP01184;SP;4359;3297;1062;2978;868;29,147;0,049;26,327
SP01185;SP;3511;2582;929;2235;719;32,170;0,040;27,847
SP01186;SP;3559;2774;785;2578;636;24,670;0,036;22,927
SP01187;SP;2356;1723;633;1485;509;34,276;0,029;29,541
SP01188;SP;1590;1156;434;1027;367;35,735;0,021;31,747
SP01189;SP;5883;4012;1871;3572;966;27,044;0,054;24,078
SP01190;SP;5137;3599;1538;3201;941;29,397;0,053;26,146
SP01191;SP;7205;5151;2054;4453;1433;32,181;0,081;27,820
SP01192;SP;5481;3973;1508;3473;1022;29,427;0,057;25,724
SP01193;SP;6918;4893;2025;4244;1198;28,228;0,067;24,484
SP01194;SP;3150;2305;845;2000;684;34,200;0,038;29,675
SP01195;SP;5991;4371;1620;3776;1228;32,521;0,069;28,094
SP01196;SP;6441;4626;1815;4044;1330;32,888;0,075;28,751
SP01197;SP;6065;4526;1539;3915;1170;29,885;0,066;25,851
SP01198;SP;4394;3400;994;2969;776;26,137;0,044;22,824
SP01199;SP;4561;3429;1132;2987;760;25,444;0,043;22,164
SP01200;SP;4925;3653;1272;3094;876;28,313;0,049;23,980
SP01201;SP;5937;4477;1460;3808;1154;30,305;0,065;25,776
SP01202;SP;6413;4790;1623;4188;1173;28,009;0,066;24,489
SP01203;SP;5224;4036;1188;3552;1036;29,167;0,058;25,669
SP01204;SP;5365;4097;1268;3600;1039;28,861;0,058;25,360
SP01205;SP;6483;4885;1598;4249;1192;28,054;0,067;24,401
SP01206;SP;4510;3346;1164;2988;744;24,900;0,042;22,236
SP01207;SP;4349;3294;1055;2882;816;28,314;0,046;24,772
SP01208;SP;6891;5231;1660;4537;1385;30,527;0,078;26,477
SP01209;SP;7838;5777;2061;4973;1574;31,651;0,089;27,246
SP01210;SP;3150;2428;722;2062;605;29,340;0,034;24,918
SP01211;SP;4601;3490;1111;2958;908;30,696;0,051;26,017
SP01212;SP;7434;5663;1771;5006;1484;29,644;0,083;26,205
SP01213;SP;4450;3366;1084;2935;861;29,336;0,048;25,579
SP01214;SP;5318;3918;1400;3343;927;27,730;0,052;23,660
SP01215;SP;6563;4951;1612;4248;1267;29,826;0,071;25,591
SP01216;SP;4894;3798;1096;3196;990;30,976;0,056;26,066
SP01217;SP;2233;1667;566;1397;500;35,791;0,028;29,994
SP01218;SP;1256;984;272;820;250;30,488;0,014;25,407
SP01219;SP;3597;2723;874;2321;731;31,495;0,041;26,845
SP01220;SP;2623;2080;543;1779;612;34,401;0,034;29,423
SP01221;SP;4891;3743;1148;3234;1023;31,633;0,058;27,331
SP01222;SP;2122;1664;458;1414;487;34,441;0,027;29,267
SP01223;SP;3886;2757;1129;2441;743;30,438;0,042;26,950
SP01224;SP;2283;1638;645;1422;412;28,973;0,023;25,153
SP01225;SP;458;358;100;307;105;34,202;0,006;29,330
SP01226;SP;959;721;238;606;201;33,168;0,011;27,878
SP01227;SP;4013;2907;1106;2532;854;33,728;0,048;29,377
SP01228;SP;4077;2878;1199;2453;836;34,081;0,047;29,048
SP01229;SP;5709;4410;1299;3825;1299;33,961;0,073;29,456
SP01230;SP;2563;1804;759;1546;550;35,576;0,031;30,488
SP01231;SP;4357;2845;1512;2525;864;34,218;0,049;30,369
SP01232;SP;4544;3180;1364;2758;929;33,684;0,052;29,214
SP01233;SP;3348;2374;974;2061;618;29,985;0,035;26,032
SP01234;SP;1567;1085;482;935;314;33,583;0,018;28,940
SP01235;SP;7584;5463;2121;4655;1623;34,866;0,091;29,709
SP01236;SP;4335;3024;1311;2607;918;35,213;0,052;30,357
SP01237;SP;5922;4157;1765;3581;1148;32,058;0,065;27,616
SP01238;SP;4275;3201;1074;2740;875;31,934;0,049;27,335
SP01239;SP;6020;4603;1417;3951;1224;30,979;0,069;26,591
SP01240;SP;2099;1609;490;1399;444;31,737;0,025;27,595
SP01241;SP;6681;4962;1719;4241;1268;29,899;0,071;25,554
SP01242;SP;3576;2712;864;2350;764;32,511;0,043;28,171
SP01243;SP;4912;3806;1106;3313;1103;33,293;0,062;28,981
SP01244;SP;3449;2654;795;2317;817;35,261;0,046;30,784
SP01245;SP;7927;6126;1801;5373;1620;30,151;0,091;26,445
SP01246;SP;6332;4869;1463;4202;1255;29,867;0,071;25,775
SP01247;SP;4854;3719;1135;3235;1055;32,612;0,059;28,368
SP01248;SP;6322;4741;1581;4109;1388;33,780;0,078;29,277
SP01249;SP;7808;5587;2221;4801;1475;30,723;0,083;26,401
SP01250;SP;4254;3209;1045;2779;880;31,666;0,050;27,423
SP01251;SP;5249;3752;1497;3249;1029;31,671;0,058;27,425
SP01252;SP;3905;2982;923;2543;773;30,397;0,043;25,922
SP01253;SP;1578;1203;375;1059;340;32,106;0,019;28,263
SP01254;SP;7148;5309;1839;4626;1330;28,751;0,075;25,052
SP01255;SP;5145;3807;1338;3236;940;29,048;0,053;24,691
SP01256;SP;6264;4532;1732;3944;1443;36,587;0,081;31,840
SP01257;SP;3540;2731;809;2355;743;31,550;0,042;27,206
SP01258;SP;3588;2646;942;2276;709;31,151;0,040;26,795
SP01259;SP;1800;1367;433;1201;416;34,638;0,023;30,432
SP01260;SP;5635;4150;1485;3556;1182;33,240;0,066;28,482
SP01261;SP;4017;2950;1067;2557;842;32,929;0,047;28,542
SP01262;SP;4424;3380;1044;2910;996;34,227;0,056;29,467
SP01263;SP;3672;2336;1336;1991;640;32,145;0,036;27,397
SP01264;SP;1742;1334;408;1118;443;39,624;0,025;33,208
SP01265;SP;2308;1638;670;1393;514;36,899;0,029;31,380
SP01266;SP;2296;1623;673;1411;452;32,034;0,025;27,850
SP01267;SP;3668;2674;994;2299;820;35,668;0,046;30,666
SP01268;SP;1395;1028;367;899;348;38,710;0,020;33,852
SP01269;SP;1317;1017;300;874;266;30,435;0,015;26,155
SP01270;SP;767;581;186;509;182;35,756;0,010;31,325
SP01271;SP;3998;2821;1177;2542;911;35,838;0,051;32,294
SP01272;SP;3598;2700;898;2426;835;34,419;0,047;30,926
SP01273;SP;6832;4837;1995;4316;1596;36,979;0,090;32,996
SP01274;SP;6482;4544;1938;4029;1475;36,610;0,083;32,460
SP01275;SP;8215;5845;2370;5265;1679;31,890;0,094;28,725
SP01276;SP;5814;4245;1569;3744;1185;31,651;0,067;27,915
SP01277;SP;5451;4180;1271;3715;1230;33,109;0,069;29,426
SP01278;SP;6124;4326;1798;3838;1256;32,725;0,071;29,034
SP01279;SP;7160;5349;1811;4714;1681;35,660;0,095;31,426
SP01280;SP;5845;4462;1383;3951;1219;30,853;0,069;27,320
SP01281;SP;6196;4845;1351;4350;1212;27,862;0,068;25,015
SP01282;SP;8652;6512;2140;5817;2058;35,379;0,116;31,603
SP01283;SP;4641;3663;978;3368;975;28,949;0,055;26,618
SP01284;SP;2886;2225;661;1986;691;34,794;0,039;31,056
SP01285;SP;4343;3311;1032;2984;904;30,295;0,051;27,303
SP01286;SP;5329;4185;1144;3770;1442;38,249;0,081;34,456
SP01287;SP;4630;3599;1031;3263;888;27,214;0,050;24,674
SP01288;SP;3628;2787;841;2512;818;32,564;0,046;29,351
SP01289;SP;8261;6336;1925;5625;1949;34,649;0,110;30,761
SP01290;SP;5911;4545;1366;4081;1515;37,123;0,085;33,333
SP01291;SP;2147;1685;462;1522;467;30,683;0,026;27,715
SP01292;SP;5775;4372;1403;3949;1249;31,628;0,070;28,568
SP01293;SP;8374;6450;1924;5808;1914;32,955;0,108;29,674
SP01294;SP;5309;4157;1152;3699;1337;36,145;0,075;32,163
SP01295;SP;3038;2368;670;2129;774;36,355;0,044;32,686
SP01296;SP;1918;1444;474;1312;369;28,125;0,021;25,554
SP01297;SP;5073;3989;1084;3512;1229;34,994;0,069;30,810
SP01298;SP;4397;3285;1112;2937;944;32,142;0,053;28,737
SP01299;SP;3911;3018;893;2702;890;32,939;0,050;29,490
SP01300;SP;3153;2400;753;2207;604;27,367;0,034;25,167
SP01301;SP;2227;1757;470;1575;469;29,778;0,026;26,693
SP01302;SP;2717;2088;629;1887;753;39,905;0,042;36,063
SP01303;SP;4518;3486;1032;3136;1040;33,163;0,059;29,834
SP01304;SP;3849;2885;964;2564;941;36,700;0,053;32,617
SP01305;SP;3647;2691;956;2402;771;32,098;0,043;28,651
SP01306;SP;10069;7542;2527;6674;2261;33,878;0,127;29,979
SP01307;SP;5091;3887;1204;3447;1309;37,975;0,074;33,676
SP01308;SP;4137;3151;986;2804;909;32,418;0,051;28,848
SP01309;SP;3292;2582;710;2342;781;33,348;0,044;30,248
SP01310;SP;5036;3741;1295;3352;1094;32,637;0,062;29,244
SP01311;SP;289;233;56;221;73;33,032;0,004;31,330
SP01312;SP;4582;3352;1230;2891;1013;35,040;0,057;30,221
SP01313;SP;5646;4362;1284;3848;1329;34,537;0,075;30,468
SP01314;SP;4826;3450;1376;3040;1103;36,283;0,062;31,971
SP01315;SP;5836;4110;1726;3619;1341;37,054;0,075;32,628
SP01316;SP;6703;4570;2133;4078;1670;40,951;0,094;36,543
SP01317;SP;7496;5230;2266;4613;1630;35,335;0,092;31,166
SP01318;SP;5897;4085;1812;3656;1305;35,695;0,073;31,946
SP01319;SP;6497;4542;1955;3958;1574;39,768;0,089;34,654
SP01320;SP;8209;6019;2190;5317;1744;32,800;0,098;28,975
SP01321;SP;5117;3907;1210;3487;1144;32,808;0,064;29,281
SP01322;SP;6445;4994;1451;4402;1531;34,780;0,086;30,657
SP01323;SP;6741;5078;1663;4526;1583;34,976;0,089;31,174
SP01324;SP;1575;1123;452;990;400;40,404;0,023;35,619
SP01325;SP;2946;2309;637;2036;730;35,855;0,041;31,615
SP01326;SP;4913;3679;1234;3172;1171;36,917;0,066;31,829
SP01327;SP;5676;4019;1657;3516;1314;37,372;0,074;32,695
SP01328;SP;6187;4762;1425;4248;1550;36,488;0,087;32,549
SP01329;SP;3596;2704;892;2348;735;31,303;0,041;27,182
SP01330;SP;7538;5905;1633;5381;1610;29,920;0,091;27,265
SP01331;SP;1932;1420;512;1244;420;33,762;0,024;29,577
SP01332;SP;5043;3673;1370;3227;1097;33,994;0,062;29,867
SP01333;SP;8821;6398;2423;5618;2504;44,571;0,141;39,137
SP01334;SP;5470;3996;1474;3544;1417;39,983;0,080;35,460
SP01335;SP;7407;5504;1903;4783;1773;37,069;0,100;32,213
SP01336;SP;6381;4725;1656;4087;1526;37,338;0,086;32,296
SP01337;SP;5929;4445;1484;3891;1374;35,312;0,077;30,911
SP01338;SP;10511;7553;2958;6604;2858;43,277;0,161;37,839
SP01339;SP;6726;4990;1736;4362;1596;36,589;0,090;31,984
SP01340;SP;6735;5134;1601;4545;1481;32,585;0,083;28,847
SP01341;SP;3295;2546;749;2182;701;32,126;0,039;27,533
SP01342;SP;1975;1567;408;1403;518;36,921;0,029;33,057
SP01343;SP;2274;1747;527;1538;542;35,241;0,030;31,025
SP01344;SP;1994;1507;487;1350;504;37,333;0,028;33,444
SP01345;SP;3443;2632;811;2317;799;34,484;0,045;30,357
SP01346;SP;4333;3268;1065;2880;1040;36,111;0,059;31,824
SP01347;SP;7950;5978;1972;5442;1867;34,307;0,105;31,231
SP01348;SP;3369;2354;1015;2058;805;39,116;0,045;34,197
SP01349;SP;7723;5766;1957;5072;2031;40,043;0,114;35,224
SP01350;SP;8729;6265;2464;5416;2137;39,457;0,120;34,110
SP01351;SP;1693;1310;383;1134;402;35,450;0,023;30,687
SP01352;SP;9339;6776;2563;5976;2583;43,223;0,145;38,120
SP01353;SP;3717;2767;950;2403;898;37,370;0,051;32,454
SP01354;SP;7702;5819;1883;5063;1983;39,167;0,112;34,078
SP01355;SP;1496;1068;428;936;340;36,325;0,019;31,835
SP01356;SP;1180;887;293;776;249;32,088;0,014;28,072
SP01357;SP;2333;1739;594;1534;646;42,112;0,036;37,148
SP01358;SP;931;614;317;552;234;42,391;0,013;38,111
SP01359;SP;839;573;266;498;209;41,968;0,012;36,475
SP01360;SP;4177;2805;1372;2518;915;36,338;0,051;32,620
SP01361;SP;7818;5512;2306;4949;1588;32,087;0,089;28,810
SP01362;SP;7767;5488;2279;4941;1600;32,382;0,090;29,155
SP01363;SP;5696;3998;1698;3484;1142;32,778;0,064;28,564
SP01364;SP;3423;2550;873;2236;684;30,590;0,038;26,824
SP01365;SP;4472;3176;1296;2790;887;31,792;0,050;27,928
SP01366;SP;6944;5099;1845;4461;1690;37,884;0,095;33,144
SP01367;SP;4323;3020;1303;2694;949;35,226;0,053;31,424
SP01368;SP;6668;5077;1591;4519;1311;29,011;0,074;25,822
SP01369;SP;3307;2556;751;2233;710;31,796;0,040;27,778
SP01370;SP;6243;4702;1541;4183;1386;33,134;0,078;29,477
SP01371;SP;7808;5764;2044;5049;1806;35,769;0,102;31,332
SP01372;SP;2774;2111;663;1886;587;31,124;0,033;27,807
SP01373;SP;6512;4729;1783;4169;1721;41,281;0,097;36,392
SP01374;SP;3027;2274;753;2041;706;34,591;0,040;31,047
SP01375;SP;4586;3582;1004;3214;1014;31,549;0,057;28,308
SP01376;SP;2812;2168;644;1956;720;36,810;0,041;33,210
SP01377;SP;6246;4413;1833;3830;1411;36,841;0,079;31,974
SP01378;SP;5134;3809;1325;3335;1169;35,052;0,066;30,690
SP01379;SP;1511;1006;505;905;320;35,359;0,018;31,809
SP01380;SP;6398;4752;1646;4316;1416;32,808;0,080;29,798
SP01381;SP;5235;3846;1389;3384;1139;33,658;0,064;29,615
SP01382;SP;4773;3511;1262;3083;1059;34,350;0,060;30,162
SP01383;SP;3644;2668;976;2378;945;39,739;0,053;35,420
SP01384;SP;1615;1256;359;1137;355;31,223;0,020;28,264
SP01385;SP;2603;1862;741;1656;609;36,775;0,034;32,707
SP01386;SP;5463;4021;1442;3562;1244;34,924;0,070;30,938
SP01387;SP;3279;2548;731;2234;851;38,093;0,048;33,399
SP01388;SP;4349;3282;1067;2911;900;30,917;0,051;27,422
SP01389;SP;5537;3939;1598;3498;1266;36,192;0,071;32,140
SP01390;SP;5471;4004;1467;3573;1156;32,354;0,065;28,871
SP01391;SP;5920;4493;1427;3998;1228;30,715;0,069;27,331
SP01392;SP;5417;4157;1260;3701;1256;33,937;0,071;30,214
SP01393;SP;4576;3329;1247;2957;1083;36,625;0,061;32,532
SP01394;SP;3196;2477;719;2198;738;33,576;0,042;29,794
SP01395;SP;5978;4264;1714;3934;1231;31,291;0,069;28,870
SP01396;SP;6178;4398;1780;3785;1252;33,078;0,070;28,467
SP01397;SP;8800;6245;2555;5605;1933;34,487;0,109;30,953
SP01398;SP;4499;3199;1300;2816;859;30,504;0,048;26,852
SP01399;SP;8543;6119;2424;5337;1785;33,446;0,100;29,171
SP01400;SP;5413;3890;1523;3412;1210;35,463;0,068;31,105
SP01401;SP;8695;6029;2666;5572;1936;34,745;0,109;32,111
SP01402;SP;5706;3956;1750;3565;1072;30,070;0,060;27,098
SP01403;SP;4451;2899;1552;2568;754;29,361;0,042;26,009
SP01404;SP;6132;4322;1810;3837;1132;29,502;0,064;26,192
SP01405;SP;6097;4577;1520;4113;1469;35,716;0,083;32,095
SP01406;SP;4561;3277;1284;2885;914;31,681;0,051;27,891
SP01407;SP;5751;3974;1777;3543;1071;30,229;0,060;26,950
SP01408;SP;3519;2466;1053;2207;684;30,992;0,038;27,737
SP01409;SP;4997;3488;1509;3180;879;27,642;0,049;25,201
SP01410;SP;6568;4871;1697;4604;1150;24,978;0,065;23,609
SP01411;SP;5127;3922;1205;3468;1106;31,892;0,062;28,200
SP01412;SP;6509;4892;1617;4341;1258;28,979;0,071;25,715
SP01413;SP;5838;4146;1692;3672;1204;32,789;0,068;29,040
SP01414;SP;11881;8889;2992;7974;2334;29,270;0,131;26,257
SP01415;SP;5045;3690;1355;3257;1239;38,041;0,070;33,577
SP01416;SP;3507;2633;874;2279;898;39,403;0,051;34,106
SP01417;SP;8205;6028;2177;5308;1936;36,473;0,109;32,117
SP01418;SP;3824;2872;952;2569;787;30,634;0,044;27,403
SP01419;SP;3045;2200;845;1950;597;30,615;0,034;27,136
SP01420;SP;3530;2622;908;2277;832;36,539;0,047;31,732
SP01421;SP;9984;7349;2635;6818;2198;32,238;0,124;29,909
SP01422;SP;3948;3053;895;2730;758;27,766;0,043;24,828
SP01423;SP;3120;2433;687;2156;710;32,931;0,040;29,182
SP01424;SP;2544;1992;552;1760;598;33,977;0,034;30,020
SP01425;SP;3763;2914;849;2663;799;30,004;0,045;27,419
SP01426;SP;4324;3303;1021;3036;927;30,534;0,052;28,065
SP01427;SP;13842;9705;4137;8889;3256;36,630;0,183;33,550
SP01428;SP;957;725;232;647;209;32,303;0,012;28,828
SP01429;SP;6808;4939;1869;4295;1664;38,743;0,094;33,691
SP01430;SP;2960;2182;778;1957;548;28,002;0,031;25,115
SP01431;SP;1550;1184;366;1064;334;31,391;0,019;28,209
SP01432;SP;2374;1762;612;1626;535;32,903;0,030;30,363
SP01433;SP;2066;1622;444;1403;523;37,277;0,029;32,244
SP01434;SP;1266;976;290;903;266;29,457;0,015;27,254
SP01435;SP;1570;1150;420;1006;400;39,761;0,023;34,783
SP01436;SP;3934;2767;1167;2419;855;35,345;0,048;30,900
SP01437;SP;5207;3881;1326;3356;1226;36,532;0,069;31,590
SP01438;SP;7108;5103;2005;4540;1404;30,925;0,079;27,513
SP01439;SP;4463;3192;1271;2834;780;27,523;0,044;24,436
SP01440;SP;4739;3347;1392;2880;1006;34,931;0,057;30,057
SP01441;SP;6375;4340;2035;3710;1238;33,369;0,070;28,525
SP01442;SP;5335;4064;1271;3499;1249;35,696;0,070;30,733
SP01443;SP;6125;4668;1457;4090;1385;33,863;0,078;29,670
SP01444;SP;5456;4304;1152;3783;1206;31,879;0,068;28,020
SP01445;SP;5567;4250;1317;3683;1207;32,772;0,068;28,400
SP01446;SP;4917;3793;1124;3310;1069;32,296;0,060;28,183
SP01447;SP;4389;3373;1016;2967;1234;41,591;0,069;36,585
SP01448;SP;2723;2084;639;1859;531;28,564;0,030;25,480
SP01449;SP;4414;3387;1027;2966;1057;35,637;0,059;31,208
SP01450;SP;5727;4301;1426;3761;1498;39,830;0,084;34,829
SP01451;SP;4196;3104;1092;2671;922;34,519;0,052;29,704
SP01452;SP;5785;4402;1383;3828;1388;36,259;0,078;31,531
SP01453;SP;6778;5078;1700;4370;1581;36,178;0,089;31,134
SP01454;SP;4757;3785;972;3340;1477;44,222;0,083;39,022
SP01455;SP;5140;3917;1223;3490;1279;36,648;0,072;32,653
SP01456;SP;5392;4124;1268;3613;1208;33,435;0,068;29,292
SP01457;SP;4727;3479;1248;2950;932;31,593;0,052;26,789
SP01458;SP;4088;3057;1031;2744;753;27,442;0,042;24,632
SP01459;SP;4391;3272;1119;2874;1159;40,327;0,065;35,422
SP01460;SP;3158;2407;751;2125;748;35,200;0,042;31,076
SP01461;SP;6903;5217;1686;4584;1754;38,264;0,099;33,621
SP01462;SP;7003;5161;1842;4481;1714;38,250;0,096;33,211
SP01463;SP;4734;3558;1176;3155;906;28,716;0,051;25,464
SP01464;SP;4055;2968;1087;2573;904;35,134;0,051;30,458
SP01465;SP;3773;2818;955;2396;815;34,015;0,046;28,921
SP01466;SP;5214;3923;1291;3405;1290;37,885;0,073;32,883
SP01467;SP;3037;2270;767;1981;807;40,737;0,045;35,551
SP01468;SP;3098;2339;759;2060;773;37,524;0,043;33,048
SP01469;SP;5075;3731;1344;3234;1138;35,189;0,064;30,501
SP01470;SP;3423;2517;906;2181;848;38,881;0,048;33,691
SP01471;SP;1901;1496;405;1299;468;36,028;0,026;31,283
SP01472;SP;3226;2317;909;2035;883;43,391;0,050;38,110
SP01473;SP;5784;3936;1848;3377;1176;34,824;0,066;29,878
SP01474;SP;7185;5083;2102;4535;1203;26,527;0,068;23,667
SP01475;SP;3961;2752;1209;2429;687;28,283;0,039;24,964
SP01476;SP;4315;3049;1266;2671;769;28,791;0,043;25,221
SP01477;SP;6382;4456;1926;3956;1127;28,488;0,063;25,292
SP01478;SP;7765;5221;2544;4569;1265;27,687;0,071;24,229
SP01479;SP;7013;5355;1658;4658;1451;31,151;0,082;27,096
SP01480;SP;6794;4702;2092;4169;1230;29,503;0,069;26,159
SP01481;SP;2868;2080;788;1806;558;30,897;0,031;26,827
SP01482;SP;6480;4781;1699;4110;1218;29,635;0,069;25,476
SP01483;SP;5423;3997;1426;3531;953;26,990;0,054;23,843
SP01484;SP;4803;3637;1166;3208;860;26,808;0,048;23,646
SP01485;SP;4366;3308;1058;2932;763;26,023;0,043;23,065
SP01486;SP;6492;4955;1537;4417;1160;26,262;0,065;23,411
SP01487;SP;5209;4004;1205;3538;1133;32,024;0,064;28,297
SP01488;SP;4853;3805;1048;3404;827;24,295;0,047;21,735
SP01489;SP;7577;5491;2086;4791;1341;27,990;0,075;24,422
SP01490;SP;5134;3970;1164;3542;970;27,386;0,055;24,433
SP01491;SP;4927;3538;1389;3139;824;26,250;0,046;23,290
SP01492;SP;6727;4828;1899;4222;1486;35,197;0,084;30,779
SP01493;SP;3722;2712;1010;2415;696;28,820;0,039;25,664
SP01494;SP;6825;4925;1900;4309;1355;31,446;0,076;27,513
SP01495;SP;5651;4282;1369;3771;1064;28,215;0,060;24,848
SP01496;SP;5781;4430;1351;3904;1524;39,037;0,086;34,402
SP01497;SP;5264;3875;1389;3457;977;28,261;0,055;25,213
SP01498;SP;5725;4260;1465;3772;1015;26,909;0,057;23,826
SP01499;SP;2259;1673;586;1501;493;32,845;0,028;29,468
SP01500;SP;1399;1031;368;928;240;25,862;0,014;23,278
SP01501;SP;923;701;222;621;158;25,443;0,009;22,539
SP01502;SP;4069;3074;995;2732;721;26,391;0,041;23,455
SP01503;SP;5963;4430;1533;3835;1251;32,621;0,070;28,239
SP01504;SP;3973;2869;1104;2569;720;28,026;0,041;25,096
SP01505;SP;1275;993;282;883;252;28,539;0,014;25,378
SP01506;SP;3179;2206;973;1958;716;36,568;0,040;32,457
SP01507;SP;2166;1623;543;1470;440;29,932;0,025;27,110
SP01508;SP;2503;1903;600;1691;498;29,450;0,028;26,169
SP01509;SP;2116;1553;563;1373;352;25,637;0,020;22,666
SP01510;SP;2124;1616;508;1403;440;31,361;0,025;27,228
SP01511;SP;1342;1040;302;932;308;33,047;0,017;29,615
SP01512;SP;1736;1367;369;1191;306;25,693;0,017;22,385
SP01513;SP;3487;2433;1054;2134;791;37,067;0,044;32,511
SP01514;SP;980;606;374;517;173;33,462;0,010;28,548
SP01515;SP;216;143;73;120;35;29,167;0,002;24,476
SP01516;SP;273;173;100;150;48;32,000;0,003;27,746
SP01517;SP;8843;6741;2102;6026;2227;36,957;0,125;33,037
SP01518;SP;6543;4968;1575;4384;1450;33,075;0,082;29,187
SP01519;SP;3483;2615;868;2301;654;28,422;0,037;25,010
SP01520;SP;4453;3273;1180;2875;858;29,843;0,048;26,214
SP01521;SP;6526;4864;1662;4328;1215;28,073;0,068;24,979
SP01522;SP;2437;1847;590;1641;369;22,486;0,021;19,978
SP01523;SP;6929;5448;1481;4814;1733;35,999;0,097;31,810
SP01524;SP;6877;5256;1621;4666;1507;32,297;0,085;28,672
SP01525;SP;5422;3635;1787;3202;939;29,325;0,053;25,832
SP01526;SP;5784;4463;1321;3989;1246;31,236;0,070;27,918
SP01527;SP;5330;3896;1434;3460;1089;31,474;0,061;27,952
SP01528;SP;3192;2439;753;2168;641;29,566;0,036;26,281
SP01529;SP;8092;6107;1985;5375;1716;31,926;0,097;28,099
SP01530;SP;4997;3947;1050;3513;1210;34,443;0,068;30,656
SP01531;SP;2226;1683;543;1487;435;29,254;0,024;25,847
SP01532;SP;6761;4811;1950;4244;1230;28,982;0,069;25,566
SP01533;SP;7786;5910;1876;5247;1767;33,676;0,099;29,898
SP01534;SP;4049;2999;1050;2659;777;29,222;0,044;25,909
SP01535;SP;4410;3225;1185;2867;748;26,090;0,042;23,194
SP01536;SP;6545;4984;1561;4440;1368;30,811;0,077;27,448
SP01537;SP;6049;4677;1372;4121;1476;35,817;0,083;31,559
SP01538;SP;4587;3519;1068;3098;868;28,018;0,049;24,666
SP01539;SP;2252;1662;590;1477;276;18,687;0,016;16,606
SP01540;SP;3159;2384;775;2096;505;24,094;0,028;21,183
SP01541;SP;3438;2552;886;2199;393;17,872;0,022;15,400
SP01542;SP;1396;1051;345;914;293;32,057;0,016;27,878
SP01543;SP;6952;5280;1672;4617;1704;36,907;0,096;32,273
SP01544;SP;4162;3047;1115;2655;994;37,439;0,056;32,622
SP01545;SP;3463;2599;864;2291;781;34,090;0,044;30,050
SP01546;SP;4679;3573;1106;3189;992;31,107;0,056;27,764
SP01547;SP;2943;2176;767;1913;577;30,162;0,032;26,517
SP01548;SP;5863;4587;1276;4067;1459;35,874;0,082;31,807
SP01549;SP;4270;3162;1108;2813;979;34,803;0,055;30,961
SP01550;SP;1274;1007;267;897;233;25,975;0,013;23,138
SP01551;SP;3659;2697;962;2340;870;37,179;0,049;32,258
SP01552;SP;3370;2381;989;2091;653;31,229;0,037;27,425
SP01553;SP;5645;4179;1466;3664;1421;38,783;0,080;34,003
SP01554;SP;5840;4399;1441;3859;1264;32,755;0,071;28,734
SP01555;SP;3529;2670;859;2370;818;34,515;0,046;30,637
SP01556;SP;2397;1711;686;1505;504;33,488;0,028;29,456
SP01557;SP;2937;1989;948;1748;537;30,721;0,030;26,998
SP01558;SP;4788;3601;1187;3171;1140;35,951;0,064;31,658
SP01559;SP;1425;1130;295;969;277;28,586;0,016;24,513
SP01560;SP;1433;987;446;860;314;36,512;0,018;31,814
SP01561;SP;1622;1303;319;1154;237;20,537;0,013;18,189
SP01562;SP;1550;1175;375;1032;361;34,981;0,020;30,723
SP01563;SP;1842;1316;526;1181;475;40,220;0,027;36,094
SP01564;SP;1289;964;325;853;282;33,060;0,016;29,253
SP01565;SP;1058;799;259;721;259;35,922;0,015;32,416
SP01566;SP;2212;1467;745;1281;487;38,017;0,027;33,197
SP01567;SP;425;269;156;236;96;40,678;0,005;35,688
SP01568;SP;443;272;171;236;96;40,678;0,005;35,294
SP01569;SP;570;403;167;353;124;35,127;0,007;30,769
SP01570;SP;80;69;11;59;22;37,288;0,001;31,884
SP01571;SP;115;102;13;92;26;28,261;0,001;25,490
SP01572;SP;253;227;26;197;78;39,594;0,004;34,361
SP01573;SP;70;53;17;48;12;25,000;0,001;22,642
SP01574;SP;7876;5506;2370;4832;1499;31,022;0,084;27,225
SP01575;SP;4037;2763;1274;2408;789;32,766;0,044;28,556
SP01576;SP;4532;3498;1034;3080;995;32,305;0,056;28,445
SP01577;SP;4405;3382;1023;3022;1017;33,653;0,057;30,071
SP01578;SP;5035;3915;1120;3477;1123;32,298;0,063;28,685
SP01579;SP;3634;2823;811;2463;810;32,887;0,046;28,693
SP01580;SP;12295;8363;3932;7512;2089;27,809;0,118;24,979
SP01581;SP;5066;3570;1496;3202;967;30,200;0,054;27,087
SP01582;SP;5360;3974;1386;3565;977;27,405;0,055;24,585
SP01583;SP;5432;4096;1336;3652;964;26,396;0,054;23,535
SP01584;SP;4414;3438;976;3032;820;27,045;0,046;23,851
SP01585;SP;5347;3952;1395;3456;971;28,096;0,055;24,570
SP01586;SP;4583;3528;1055;3144;1273;40,490;0,072;36,083
SP01587;SP;2480;1899;581;1728;606;35,069;0,034;31,912
SP01588;SP;4161;3146;1015;2856;894;31,303;0,050;28,417
SP01589;SP;5101;3963;1138;3565;972;27,265;0,055;24,527
SP01590;SP;2697;2047;650;1825;595;32,603;0,033;29,067
SP01591;SP;5257;4209;1048;3840;1211;31,536;0,068;28,772
SP01592;SP;5927;4366;1561;3887;1148;29,534;0,065;26,294
SP01593;SP;3907;3008;899;2696;809;30,007;0,046;26,895
SP01594;SP;3504;2794;710;2526;882;34,917;0,050;31,568
SP01595;SP;3343;2577;766;2347;628;26,758;0,035;24,369
SP01596;SP;3064;2318;746;2075;662;31,904;0,037;28,559
SP01597;SP;2735;2080;655;1868;700;37,473;0,039;33,654
SP01598;SP;2456;1811;645;1589;523;32,914;0,029;28,879
SP01599;SP;4566;3418;1148;3025;1029;34,017;0,058;30,105
SP01600;SP;2074;1607;467;1436;442;30,780;0,025;27,505
SP01601;SP;1244;1003;241;910;274;30,110;0,015;27,318
SP01602;SP;5026;3719;1307;3254;1054;32,391;0,059;28,341
SP01603;SP;3140;2352;788;2071;608;29,358;0,034;25,850
SP01604;SP;2213;1640;573;1458;645;44,239;0,036;39,329
SP01605;SP;2247;1702;545;1538;538;34,980;0,030;31,610
SP01606;SP;3909;2776;1133;2467;1022;41,427;0,057;36,816
SP01607;SP;1156;906;250;797;222;27,854;0,012;24,503
SP01608;SP;2455;1874;581;1669;577;34,572;0,032;30,790
SP01609;SP;4359;3104;1255;2727;913;33,480;0,051;29,414
SP01610;SP;3105;2321;784;2039;678;33,252;0,038;29,212
SP01611;SP;1491;1126;365;1010;369;36,535;0,021;32,771
SP01612;SP;5316;3928;1388;3541;938;26,490;0,053;23,880
SP01613;SP;5274;3845;1429;3423;797;23,284;0,045;20,728
SP01614;SP;5270;3880;1390;3532;902;25,538;0,051;23,247
SP01615;SP;1988;1563;425;1420;365;25,704;0,021;23,353
SP01616;SP;5568;4270;1298;3871;1062;27,435;0,060;24,871
SP01617;SP;6274;4569;1705;4003;1073;26,805;0,060;23,484
SP01618;SP;8129;6088;2041;5356;1363;25,448;0,077;22,388
SP01619;SP;6560;4738;1822;4200;1035;24,643;0,058;21,845
SP01620;SP;3851;2955;896;2665;680;25,516;0,038;23,012
SP01621;SP;5101;3838;1263;3443;879;25,530;0,049;22,903
SP01622;SP;4052;2947;1105;2631;677;25,732;0,038;22,973
SP01623;SP;3923;2803;1120;2508;603;24,043;0,034;21,513
SP01624;SP;7719;5518;2201;4887;1086;22,222;0,061;19,681
SP01625;SP;5942;4747;1195;4257;1181;27,743;0,066;24,879
SP01626;SP;2768;2232;536;1988;553;27,817;0,031;24,776
SP01627;SP;4603;3009;1594;2680;660;24,627;0,037;21,934
SP01628;SP;974;709;265;634;137;21,609;0,008;19,323
SP01629;SP;3617;2806;811;2509;579;23,077;0,033;20,634
SP01630;SP;1721;1304;417;1174;304;25,894;0,017;23,313
SP01631;SP;3548;2705;843;2418;632;26,137;0,036;23,364
SP01632;SP;5894;4098;1796;3675;969;26,367;0,055;23,646
SP01633;SP;5184;3704;1480;3305;790;23,903;0,044;21,328
SP01634;SP;1387;1023;364;909;251;27,613;0,014;24,536
SP01635;SP;6200;4212;1988;3764;913;24,256;0,051;21,676
SP01636;SP;4041;3118;923;2774;707;25,487;0,040;22,675
SP01637;SP;1545;1206;339;1069;299;27,970;0,017;24,793
SP01638;SP;2663;1969;694;1802;516;28,635;0,029;26,206
SP01639;SP;778;553;225;480;152;31,667;0,009;27,486
SP01640;SP;2145;1572;573;1444;403;27,909;0,023;25,636
SP01641;SP;5788;4414;1374;3889;900;23,142;0,051;20,390
SP01642;SP;2330;1658;672;1478;501;33,897;0,028;30,217
SP01643;SP;6423;4412;2011;3866;1158;29,953;0,065;26,247
SP01644;SP;6058;4635;1423;4037;1164;28,833;0,065;25,113
SP01645;SP;4193;2916;1277;2634;714;27,107;0,040;24,486
SP01646;SP;4342;3429;913;3051;751;24,615;0,042;21,901
SP01647;SP;3641;2859;782;2529;642;25,386;0,036;22,455
SP01648;SP;5393;4065;1328;3608;904;25,055;0,051;22,239
SP01649;SP;3698;2822;876;2558;543;21,228;0,031;19,242
SP01650;SP;1635;1317;318;1202;265;22,047;0,015;20,121
SP01651;SP;6989;5363;1626;4808;1494;31,073;0,084;27,858
SP01652;SP;5410;3880;1530;3432;952;27,739;0,054;24,536
SP01653;SP;1349;1101;248;978;272;27,812;0,015;24,705
SP01654;SP;4908;3591;1317;3246;753;23,198;0,042;20,969
SP01655;SP;3529;2415;1114;2168;552;25,461;0,031;22,857
SP01656;SP;5925;4175;1750;3719;935;25,141;0,053;22,395
SP01657;SP;2210;1667;543;1447;376;25,985;0,021;22,555
SP01658;SP;4665;3405;1260;2973;919;30,912;0,052;26,990
SP01659;SP;4975;3950;1025;3495;891;25,494;0,050;22,557
SP01660;SP;1780;1387;393;1224;331;27,042;0,019;23,864
SP01661;SP;4921;3565;1356;3170;968;30,536;0,054;27,153
SP01662;SP;5362;3769;1593;3361;845;25,141;0,048;22,420
SP01663;SP;4863;3380;1483;2975;686;23,059;0,039;20,296
SP01664;SP;4100;3227;873;2893;661;22,848;0,037;20,483
SP01665;SP;2933;2048;885;1790;462;25,810;0,026;22,559
SP01666;SP;3664;2776;888;2436;640;26,273;0,036;23,055
SP01667;SP;1115;846;269;727;220;30,261;0,012;26,005
SP01668;SP;1231;960;271;849;210;24,735;0,012;21,875
SP01669;SP;1414;1112;302;988;245;24,798;0,014;22,032
SP01670;SP;2365;1842;523;1624;429;26,416;0,024;23,290
SP01671;SP;2362;1793;569;1595;522;32,727;0,029;29,113
SP01672;SP;4183;3049;1134;2696;676;25,074;0,038;22,171
SP01673;SP;1979;1600;379;1452;370;25,482;0,021;23,125
SP01674;SP;2328;1727;601;1520;510;33,553;0,029;29,531
SP01675;SP;7296;5435;1861;4717;1485;31,482;0,084;27,323
SP01676;SP;7202;5553;1649;4710;1730;36,730;0,097;31,154
SP01677;SP;6587;4822;1765;4043;1195;29,557;0,067;24,782
SP01678;SP;6291;4642;1649;4011;1306;32,560;0,073;28,134
SP01679;SP;6584;5223;1361;4527;1586;35,034;0,089;30,366
SP01680;SP;5598;4355;1243;3806;1015;26,668;0,057;23,307
SP01681;SP;6345;4849;1496;4224;1397;33,073;0,079;28,810
SP01682;SP;3870;2932;938;2463;668;27,121;0,038;22,783
SP01683;SP;4635;3492;1143;3034;775;25,544;0,044;22,194
SP01684;SP;4928;3721;1207;3261;1014;31,095;0,057;27,251
SP01685;SP;7787;5783;2004;4975;1660;33,367;0,093;28,705
SP01686;SP;7314;5422;1892;4713;1276;27,074;0,072;23,534
SP01687;SP;5072;3960;1112;3519;1099;31,230;0,062;27,753
SP01688;SP;5851;4458;1393;3939;1136;28,840;0,064;25,482
SP01689;SP;4779;3653;1126;3170;840;26,498;0,047;22,995
SP01690;SP;3916;3033;883;2677;710;26,522;0,040;23,409
SP01691;SP;6176;4697;1479;3990;1082;27,118;0,061;23,036
SP01692;SP;6368;4706;1662;4084;1146;28,061;0,064;24,352
SP01693;SP;5042;3888;1154;3318;940;28,330;0,053;24,177
SP01694;SP;6468;4848;1620;4165;1376;33,037;0,077;28,383
SP01695;SP;2859;2244;615;1982;547;27,598;0,031;24,376
SP01696;SP;3501;2635;866;2243;658;29,336;0,037;24,972
SP01697;SP;6299;4729;1570;4138;1311;31,682;0,074;27,723
SP01698;SP;4270;3456;814;3054;884;28,946;0,050;25,579
SP01699;SP;2649;2123;526;1874;603;32,177;0,034;28,403
SP01700;SP;3480;2776;704;2374;859;36,184;0,048;30,944
SP01701;SP;5870;4471;1399;3774;1094;28,988;0,062;24,469
SP01702;SP;2682;2122;560;1885;561;29,761;0,032;26,437
SP01703;SP;2290;1786;504;1562;453;29,001;0,025;25,364
SP01704;SP;4240;3111;1129;2596;770;29,661;0,043;24,751
SP01705;SP;1680;1237;443;1072;392;36,567;0,022;31,690
SP01706;SP;6272;4442;1830;3824;1225;32,035;0,069;27,578
SP01707;SP;5330;3733;1597;3179;1052;33,092;0,059;28,181
SP01708;SP;4897;3752;1145;3155;960;30,428;0,054;25,586
SP01709;SP;5123;4026;1097;3454;951;27,533;0,054;23,621
SP01710;SP;4727;3480;1247;2990;899;30,067;0,051;25,833
SP01711;SP;2862;2103;759;1787;576;32,233;0,032;27,389
SP01712;SP;3629;2848;781;2560;676;26,406;0,038;23,736
SP01713;SP;4285;3322;963;2994;835;27,889;0,047;25,135
SP01714;SP;3989;2965;1024;2626;801;30,503;0,045;27,015
SP01715;SP;3987;2703;1284;2406;614;25,520;0,035;22,716
SP01716;SP;3015;2185;830;1978;597;30,182;0,034;27,323
SP01717;SP;3491;2515;976;2304;624;27,083;0,035;24,811
SP01718;SP;6133;4462;1671;3987;1037;26,010;0,058;23,241
SP01719;SP;5072;3667;1405;3303;906;27,430;0,051;24,707
SP01720;SP;4886;3771;1115;3384;1015;29,994;0,057;26,916
SP01721;SP;3300;2518;782;2255;579;25,676;0,033;22,994
SP01722;SP;4433;3424;1009;3125;823;26,336;0,046;24,036
SP01723;SP;2776;2110;666;1867;532;28,495;0,030;25,213
SP01724;SP;5829;4472;1357;4029;1129;28,022;0,064;25,246
SP01725;SP;6477;4901;1576;4313;1483;34,384;0,083;30,259
SP01726;SP;4123;3080;1043;2732;819;29,978;0,046;26,591
SP01727;SP;4196;3134;1062;2801;818;29,204;0,046;26,101
SP01728;SP;3507;2774;733;2539;771;30,366;0,043;27,794
SP01729;SP;3858;2903;955;2597;849;32,692;0,048;29,246
SP01730;SP;1570;1190;380;1050;327;31,143;0,018;27,479
SP01731;SP;1980;1505;475;1340;431;32,164;0,024;28,638
SP01732;SP;5337;4122;1215;3599;1130;31,398;0,064;27,414
SP01733;SP;4951;3567;1384;3222;1055;32,744;0,059;29,577
SP01734;SP;4835;3770;1065;3360;1090;32,440;0,061;28,912
SP01735;SP;2431;1787;644;1584;517;32,639;0,029;28,931
SP01736;SP;2336;1745;591;1578;522;33,080;0,029;29,914
SP01737;SP;4533;3032;1501;2672;860;32,186;0,048;28,364
SP01738;SP;6502;4692;1810;4098;1385;33,797;0,078;29,518
SP01739;SP;4727;3508;1219;3083;926;30,036;0,052;26,397
SP01740;SP;5160;3900;1260;3385;1160;34,269;0,065;29,744
SP01741;SP;2084;1633;451;1445;497;34,394;0,028;30,435
SP01742;SP;2540;1993;547;1767;605;34,239;0,034;30,356
SP01743;SP;4150;3091;1059;2751;926;33,660;0,052;29,958
SP01744;SP;2443;1903;540;1722;531;30,836;0,030;27,903
SP01745;SP;3806;2617;1189;2260;822;36,372;0,046;31,410
SP01746;SP;1007;705;302;598;250;41,806;0,014;35,461
SP01747;SP;2073;1508;565;1299;469;36,105;0,026;31,101
SP01748;SP;3372;2550;822;2210;750;33,937;0,042;29,412
SP01749;SP;3518;2677;841;2397;849;35,419;0,048;31,715
SP01750;SP;1938;1587;351;1437;427;29,715;0,024;26,906
SP01751;SP;1150;869;281;775;245;31,613;0,014;28,193
SP01752;SP;5109;3572;1537;3090;1237;40,032;0,070;34,630
SP01753;SP;5888;4237;1651;3673;1368;37,245;0,077;32,287
SP01754;SP;5351;3944;1407;3468;1165;33,593;0,066;29,539
SP01755;SP;4747;3670;1077;3212;1148;35,741;0,065;31,281
SP01756;SP;6967;5286;1681;4627;1700;36,741;0,096;32,160
SP01757;SP;6189;4696;1493;4141;1526;36,851;0,086;32,496
SP01758;SP;4558;3594;964;3187;1132;35,519;0,064;31,497
SP01759;SP;4843;3633;1210;3235;1237;38,238;0,070;34,049
SP01760;SP;3464;2593;871;2257;803;35,578;0,045;30,968
SP01761;SP;6449;4860;1589;4313;1348;31,254;0,076;27,737
SP01762;SP;1989;1411;578;1248;478;38,301;0,027;33,877
SP01763;SP;6217;4767;1450;4196;1429;34,056;0,080;29,977
SP01764;SP;5036;3884;1152;3408;1323;38,820;0,074;34,063
SP01765;SP;3450;2545;905;2215;850;38,375;0,048;33,399
SP01766;SP;2383;1856;527;1642;591;35,993;0,033;31,843
SP01767;SP;5732;4162;1570;3641;1378;37,847;0,078;33,109
SP01768;SP;5069;3536;1533;3036;1178;38,801;0,066;33,314
SP01769;SP;4801;3442;1359;3002;1104;36,775;0,062;32,074
SP01770;SP;6174;4477;1697;3954;1568;39,656;0,088;35,023
SP01771;SP;2820;2169;651;1855;685;36,927;0,039;31,581
SP01772;SP;6424;4687;1737;4023;1551;38,553;0,087;33,092
SP01773;SP;5046;3650;1396;3220;1091;33,882;0,061;29,890
SP01774;SP;3149;2395;754;2084;693;33,253;0,039;28,935
SP01775;SP;5254;3935;1319;3449;1289;37,373;0,073;32,757
SP01776;SP;5029;3736;1293;3307;1154;34,896;0,065;30,889
SP01777;SP;4580;3464;1116;3071;1155;37,610;0,065;33,343
SP01778;SP;5530;4135;1395;3668;1154;31,461;0,065;27,908
SP01779;SP;3173;2448;725;2155;686;31,833;0,039;28,023
SP01780;SP;6187;4519;1668;3925;1445;36,815;0,081;31,976
SP01781;SP;3570;2625;945;2281;769;33,713;0,043;29,295
SP01782;SP;1588;1131;457;964;307;31,846;0,017;27,144
SP01783;SP;2547;1941;606;1699;527;31,018;0,030;27,151
SP01784;SP;5548;4158;1390;3576;1268;35,459;0,071;30,495
SP01785;SP;3906;2901;1005;2512;941;37,460;0,053;32,437
SP01786;SP;5053;3795;1258;3323;1198;36,052;0,067;31,568
SP01787;SP;2575;1937;638;1694;616;36,364;0,035;31,802
SP01788;SP;4509;3253;1256;2828;1113;39,356;0,063;34,215
SP01789;SP;5960;4385;1575;3822;1494;39,089;0,084;34,071
SP01790;SP;3198;2376;822;2102;830;39,486;0,047;34,933
SP01791;SP;5115;3578;1537;3098;1076;34,732;0,061;30,073
SP01792;SP;4050;2861;1189;2527;1035;40,958;0,058;36,176
SP01793;SP;3967;2708;1259;2358;902;38,253;0,051;33,309
SP01794;SP;774;543;231;479;197;41,127;0,011;36,280
SP01795;SP;3220;2405;815;2149;876;40,763;0,049;36,424
SP01796;SP;5940;4145;1795;3620;1095;30,249;0,062;26,417
SP01797;SP;6711;4719;1992;4130;1372;33,220;0,077;29,074
SP01798;SP;7205;5180;2025;4589;1483;32,316;0,083;28,629
SP01799;SP;7489;5627;1862;4986;1540;30,886;0,087;27,368
SP01800;SP;8375;5972;2403;5247;1617;30,818;0,091;27,076
SP01801;SP;4591;3418;1173;3027;854;28,213;0,048;24,985
SP01802;SP;4568;3396;1172;3025;949;31,372;0,053;27,945
SP01803;SP;6098;4524;1574;3959;1257;31,750;0,071;27,785
SP01804;SP;6591;4968;1623;4370;1326;30,343;0,075;26,691
SP01805;SP;5577;4145;1432;3598;1174;32,629;0,066;28,323
SP01806;SP;4493;3478;1015;3072;992;32,292;0,056;28,522
SP01807;SP;4489;3336;1153;2891;814;28,156;0,046;24,400
SP01808;SP;2234;1638;596;1402;451;32,168;0,025;27,534
SP01809;SP;4775;3643;1132;3256;952;29,238;0,054;26,132
SP01810;SP;2637;1906;731;1652;534;32,324;0,030;28,017
SP01811;SP;6412;4710;1702;4128;1431;34,666;0,081;30,382
SP01812;SP;1538;1144;394;1008;367;36,409;0,021;32,080
SP01813;SP;5173;3885;1288;3381;1223;36,173;0,069;31,480
SP01814;SP;4705;3560;1145;3091;1152;37,269;0,065;32,360
SP01815;SP;3249;2352;897;2037;708;34,757;0,040;30,102
SP01816;SP;3092;2313;779;2088;672;32,184;0,038;29,053
SP01817;SP;3029;2174;855;1932;662;34,265;0,037;30,451
SP01818;SP;967;732;235;620;190;30,645;0,011;25,956
SP01819;SP;6180;4697;1483;4165;1384;33,229;0,078;29,466
SP01820;SP;8046;5660;2386;5190;1554;29,942;0,087;27,456
SP01821;SP;7786;5613;2173;5020;1638;32,629;0,092;29,182
SP01822;SP;6815;4948;1867;4414;1431;32,420;0,081;28,921
SP01823;SP;7272;5078;2194;4560;1496;32,807;0,084;29,460
SP01824;SP;3725;2622;1103;2323;813;34,998;0,046;31,007
SP01825;SP;5132;3457;1675;3183;886;27,835;0,050;25,629
SP01826;SP;6250;4422;1828;4059;1203;29,638;0,068;27,205
SP01827;SP;6711;4773;1938;4275;1224;28,632;0,069;25,644
SP01828;SP;8402;6116;2286;5389;1892;35,109;0,106;30,935
SP01829;SP;6875;5127;1748;4637;1634;35,238;0,092;31,870
SP01830;SP;3740;2650;1090;2388;766;32,077;0,043;28,906
SP01831;SP;3229;2462;767;2296;738;32,143;0,042;29,976
SP01832;SP;6225;4582;1643;4102;1312;31,984;0,074;28,634
SP01833;SP;6103;4442;1661;4193;916;21,846;0,052;20,621
SP01834;SP;1138;842;296;811;189;23,305;0,011;22,447
SP01835;SP;6616;4983;1633;4450;1683;37,820;0,095;33,775
SP01836;SP;6148;4540;1608;4111;1535;37,339;0,086;33,811
SP01837;SP;3345;2573;772;2300;782;34,000;0,044;30,393
SP01838;SP;3079;2250;829;2080;530;25,481;0,030;23,556
SP01839;SP;3350;2459;891;2238;703;31,412;0,040;28,589
SP01840;SP;2311;1695;616;1528;540;35,340;0,030;31,858
SP01841;SP;1166;817;349;763;233;30,537;0,013;28,519
SP01842;SP;5313;4084;1229;3603;1349;37,441;0,076;33,031
SP01843;SP;3612;2624;988;2343;799;34,102;0,045;30,450
SP01844;SP;4512;3069;1443;2881;641;22,249;0,036;20,886
SP01845;SP;6584;4733;1851;4177;1672;40,029;0,094;35,326
SP01846;SP;3222;2484;738;2151;772;35,890;0,043;31,079
SP01847;SP;2974;2307;667;2025;757;37,383;0,043;32,813
SP01848;SP;2632;1957;675;1782;592;33,221;0,033;30,250
SP01849;SP;3121;2123;998;1884;742;39,384;0,042;34,951
SP01850;SP;3510;2451;1059;2328;430;18,471;0,024;17,544
SP01851;SP;982;759;223;690;236;34,203;0,013;31,094
SP01852;SP;3141;2174;967;1932;803;41,563;0,045;36,937
SP01853;SP;3021;2306;715;2167;571;26,350;0,032;24,761
SP01854;SP;5482;3816;1666;3430;1282;37,376;0,072;33,595
SP01855;SP;3678;2595;1083;2397;941;39,257;0,053;36,262
SP01856;SP;1178;960;218;914;193;21,116;0,011;20,104
SP01857;SP;4340;2937;1403;2763;652;23,598;0,037;22,200
SP01858;SP;8697;5871;2826;5316;1323;24,887;0,074;22,534
SP01859;SP;6287;4438;1849;3946;980;24,835;0,055;22,082
SP01860;SP;6782;4893;1889;4548;1055;23,197;0,059;21,561
SP01861;SP;5487;3813;1674;3464;796;22,979;0,045;20,876
SP01862;SP;5013;3647;1366;3272;976;29,829;0,055;26,762
SP01863;SP;5889;4259;1630;3877;924;23,833;0,052;21,695
SP01864;SP;4267;3041;1226;2709;829;30,602;0,047;27,261
SP01865;SP;4732;3337;1395;2993;755;25,226;0,042;22,625
SP01866;SP;4946;3465;1481;3169;758;23,919;0,043;21,876
SP01867;SP;5509;4205;1304;3764;988;26,249;0,056;23,496
SP01868;SP;4200;3182;1018;2905;755;25,990;0,042;23,727
SP01869;SP;5661;4238;1423;3911;994;25,415;0,056;23,454
SP01870;SP;4686;3652;1034;3239;1083;33,436;0,061;29,655
SP01871;SP;7738;5921;1817;5197;2028;39,023;0,114;34,251
SP01872;SP;7613;5835;1778;5356;1422;26,550;0,080;24,370
SP01873;SP;2770;2105;665;1967;518;26,335;0,029;24,608
SP01874;SP;2682;2008;674;1874;454;24,226;0,026;22,610
SP01875;SP;5494;4292;1202;3842;1097;28,553;0,062;25,559
SP01876;SP;4608;3496;1112;3223;882;27,366;0,050;25,229
SP01877;SP;5858;4452;1406;3941;1174;29,789;0,066;26,370
SP01878;SP;4970;3583;1387;3182;825;25,927;0,046;23,025
SP01879;SP;5975;4650;1325;4286;1174;27,392;0,066;25,247
SP01880;SP;4589;3325;1264;2990;861;28,796;0,048;25,895
SP01881;SP;7339;5302;2037;4766;1260;26,437;0,071;23,765
SP01882;SP;1632;1172;460;1070;331;30,935;0,019;28,242
SP01883;SP;5157;3842;1315;3431;962;28,038;0,054;25,039
SP01884;SP;7365;5467;1898;4838;1494;30,881;0,084;27,328
SP01885;SP;1800;1407;393;1256;339;26,990;0,019;24,094
SP01886;SP;1564;1211;353;1071;410;38,282;0,023;33,856
SP01887;SP;11149;7662;3487;6846;1830;26,731;0,103;23,884
SP01888;SP;5852;4299;1553;3763;1291;34,308;0,073;30,030
SP01889;SP;7228;5214;2014;4567;1259;27,567;0,071;24,147
SP01890;SP;5322;3800;1522;3386;961;28,382;0,054;25,289
SP01891;SP;2651;2058;593;1887;598;31,691;0,034;29,057
SP01892;SP;7589;5302;2287;4747;1510;31,810;0,085;28,480
SP01893;SP;6981;4853;2128;4324;1180;27,290;0,066;24,315
SP01894;SP;7264;5494;1770;4878;1484;30,422;0,083;27,011
SP01895;SP;4468;3366;1102;2992;760;25,401;0,043;22,579
SP01896;SP;4681;3529;1152;3057;831;27,184;0,047;23,548
SP01897;SP;3517;2672;845;2338;842;36,014;0,047;31,512
SP01898;SP;4700;3612;1088;3248;875;26,940;0,049;24,225
SP01899;SP;6018;4686;1332;4199;1004;23,910;0,056;21,426
SP01900;SP;4988;3830;1158;3470;1077;31,037;0,061;28,120
SP01901;SP;2685;2070;615;1820;459;25,220;0,026;22,174
SP01902;SP;4700;3678;1022;3245;891;27,458;0,050;24,225
SP01903;SP;5816;4296;1520;3763;1048;27,850;0,059;24,395
SP01904;SP;6994;4857;2137;4237;1203;28,393;0,068;24,768
SP01905;SP;3477;2527;950;2243;644;28,712;0,036;25,485
SP01906;SP;4600;3470;1130;3074;926;30,124;0,052;26,686
SP01907;SP;5356;4156;1200;3684;1068;28,990;0,060;25,698
SP01908;SP;3792;2895;897;2527;718;28,413;0,040;24,801
SP01909;SP;2748;2096;652;1866;517;27,706;0,029;24,666
SP01910;SP;1968;1531;437;1356;439;32,375;0,025;28,674
SP01911;SP;1962;1479;483;1337;401;29,993;0,023;27,113
SP01912;SP;1369;1015;354;907;270;29,768;0,015;26,601
SP01913;SP;4665;3457;1208;3054;763;24,984;0,043;22,071
SP01914;SP;5492;3919;1573;3604;799;22,170;0,045;20,388
SP01915;SP;3924;2794;1130;2480;665;26,815;0,037;23,801
SP01916;SP;6631;4767;1864;4250;1063;25,012;0,060;22,299
SP01917;SP;4628;3281;1347;2925;691;23,624;0,039;21,061
SP01918;SP;5928;4224;1704;3776;1014;26,854;0,057;24,006
SP01919;SP;5480;3862;1618;3455;778;22,518;0,044;20,145
SP01920;SP;5883;4213;1670;3809;822;21,580;0,046;19,511
SP01921;SP;5497;3880;1617;3502;928;26,499;0,052;23,918
SP01922;SP;4328;3109;1219;2851;676;23,711;0,038;21,743
SP01923;SP;4807;3422;1385;3182;733;23,036;0,041;21,420
SP01924;SP;5115;3688;1427;3387;776;22,911;0,044;21,041
SP01925;SP;5445;4056;1389;3777;871;23,061;0,049;21,474
SP01926;SP;6354;4642;1712;4128;1079;26,139;0,061;23,244
SP01927;SP;6734;4883;1851;4348;1148;26,403;0,065;23,510
SP01928;SP;4314;2942;1372;2560;698;27,266;0,039;23,725
SP01929;SP;6511;4874;1637;4343;1034;23,808;0,058;21,215
SP01930;SP;4667;3372;1295;2967;821;27,671;0,046;24,348
SP01931;SP;5097;3731;1366;3305;899;27,201;0,051;24,095
SP01932;SP;6660;4948;1712;4315;1173;27,184;0,066;23,707
SP01933;SP;4814;3526;1288;3145;749;23,816;0,042;21,242
SP01934;SP;7848;5935;1913;5331;1367;25,642;0,077;23,033
SP01935;SP;6268;4538;1730;3983;979;24,579;0,055;21,573
SP01936;SP;7478;5533;1945;4922;1192;24,218;0,067;21,543
SP01937;SP;2730;2058;672;1908;450;23,585;0,025;21,866
SP01938;SP;7268;5458;1810;4870;1256;25,791;0,071;23,012
SP01939;SP;6689;4917;1772;4310;1159;26,891;0,065;23,571
SP01940;SP;5477;4046;1431;3511;1046;29,792;0,059;25,853
SP01941;SP;3638;2601;1037;2291;576;25,142;0,032;22,145
SP01942;SP;2838;1952;886;1738;408;23,475;0,023;20,902
SP01943;SP;3522;2387;1135;2104;585;27,804;0,033;24,508
SP01944;SP;4146;2878;1268;2532;643;25,395;0,036;22,342
SP01945;SP;778;516;262;466;124;26,609;0,007;24,031
SP01946;SP;2503;1878;625;1736;435;25,058;0,024;23,163
SP01947;SP;1722;1325;397;1234;334;27,066;0,019;25,208
SP01948;SP;4518;3392;1126;3001;856;28,524;0,048;25,236
SP01949;SP;4412;3284;1128;2886;774;26,819;0,044;23,569
SP01950;SP;3678;2686;992;2318;678;29,249;0,038;25,242
SP01951;SP;2720;1944;776;1676;512;30,549;0,029;26,337
SP01952;SP;1981;1434;547;1356;317;23,378;0,018;22,106
SP01953;SP;1981;1434;547;1356;317;23,378;0,018;22,106
SP01954;SP;2478;1836;642;1674;453;27,061;0,025;24,673
SP01955;SP;1676;1305;371;1165;313;26,867;0,018;23,985
SP01956;SP;2217;1704;513;1544;355;22,992;0,020;20,833
SP01957;SP;4354;2954;1400;2643;555;20,999;0,031;18,788
SP01958;SP;5003;3525;1478;3167;652;20,587;0,037;18,496
SP01959;SP;5593;3840;1753;3448;728;21,114;0,041;18,958
SP01960;SP;5568;3947;1621;3521;847;24,056;0,048;21,459
SP01961;SP;5779;4031;1748;3594;816;22,705;0,046;20,243
SP01962;SP;7108;5093;2015;4444;1001;22,525;0,056;19,654
SP01963;SP;6175;4386;1789;3967;930;23,443;0,052;21,204
SP01964;SP;5289;3773;1516;3393;755;22,252;0,042;20,011
SP01965;SP;6052;4377;1675;3942;826;20,954;0,046;18,871
SP01966;SP;3725;2683;1042;2388;523;21,901;0,029;19,493
SP01967;SP;4971;3676;1295;3360;681;20,268;0,038;18,526
SP01968;SP;6332;4433;1899;3944;838;21,247;0,047;18,904
SP01969;SP;4540;3384;1156;3023;714;23,619;0,040;21,099
SP01970;SP;5176;3902;1274;3479;723;20,782;0,041;18,529
SP01971;SP;4710;3628;1082;3249;626;19,267;0,035;17,255
SP01972;SP;4287;3177;1110;2831;648;22,889;0,036;20,397
SP01973;SP;4606;3323;1283;2955;652;22,064;0,037;19,621
SP01974;SP;6477;4953;1524;4390;954;21,731;0,054;19,261
SP01975;SP;3160;2466;694;2263;454;20,062;0,026;18,410
SP01976;SP;1818;1441;377;1295;281;21,699;0,016;19,500
SP01977;SP;3135;2329;806;2093;499;23,841;0,028;21,426
SP01978;SP;2051;1584;467;1405;304;21,637;0,017;19,192
SP01979;SP;3299;2595;704;2335;614;26,296;0,035;23,661
SP01980;SP;3089;2298;791;2043;489;23,935;0,028;21,279
SP01981;SP;3490;2616;874;2355;591;25,096;0,033;22,592
SP01982;SP;971;761;210;675;202;29,926;0,011;26,544
SP01983;SP;776;622;154;562;134;23,843;0,008;21,543
SP01984;SP;1613;1217;396;1076;271;25,186;0,015;22,268
SP01985;SP;977;754;223;665;176;26,466;0,010;23,342
SP01986;SP;5859;4091;1768;3592;1094;30,457;0,062;26,742
SP01987;SP;4784;3488;1296;3072;966;31,445;0,054;27,695
SP01988;SP;5876;4116;1760;3576;1178;32,942;0,066;28,620
SP01989;SP;5992;4344;1648;3833;1259;32,846;0,071;28,983
SP01990;SP;6386;4883;1503;4261;1305;30,627;0,073;26,725
SP01991;SP;6762;5186;1576;4553;1376;30,222;0,077;26,533
SP01992;SP;6492;4575;1917;3970;1338;33,703;0,075;29,246
SP01993;SP;5680;4331;1349;3805;1042;27,385;0,059;24,059
SP01994;SP;8040;6246;1794;5555;1528;27,507;0,086;24,464
SP01995;SP;5916;4532;1384;3938;1396;35,449;0,079;30,803
SP01996;SP;4065;3200;865;2826;1102;38,995;0,062;34,438
SP01997;SP;6927;5249;1678;4642;1396;30,073;0,079;26,596
SP01998;SP;6178;4568;1610;4062;1289;31,733;0,073;28,218
SP01999;SP;6988;5415;1573;4728;1471;31,113;0,083;27,165
SP02000;SP;3014;2251;763;1914;685;35,789;0,039;30,431
SP02001;SP;3226;2487;739;2109;620;29,398;0,035;24,930
SP02002;SP;3675;2757;918;2382;956;40,134;0,054;34,675
SP02003;SP;1402;1037;365;893;282;31,579;0,016;27,194
SP02004;SP;5152;3944;1208;3453;908;26,296;0,051;23,022
SP02005;SP;4698;3512;1186;3112;946;30,398;0,053;26,936
SP02006;SP;2512;1848;664;1651;527;31,920;0,030;28,517
SP02007;SP;2999;2249;750;1969;506;25,698;0,028;22,499
SP02008;SP;2358;1843;515;1633;484;29,639;0,027;26,262
SP02009;SP;2652;1977;675;1690;602;35,621;0,034;30,450
SP02010;SP;1994;1540;454;1364;409;29,985;0,023;26,558
SP02011;SP;1844;1364;480;1214;356;29,325;0,020;26,100
SP02012;SP;1265;994;271;858;272;31,702;0,015;27,364
SP02013;SP;5458;3725;1733;3224;1008;31,266;0,057;27,060
SP02014;SP;3660;2664;996;2361;698;29,564;0,039;26,201
SP02015;SP;6390;4422;1968;3805;1237;32,510;0,070;27,974
SP02016;SP;3949;2736;1213;2403;676;28,132;0,038;24,708
SP02017;SP;5843;4354;1489;3831;1168;30,488;0,066;26,826
SP02018;SP;4910;3391;1519;2913;842;28,905;0,047;24,830
SP02019;SP;5428;3779;1649;3269;994;30,407;0,056;26,303
SP02020;SP;5169;3750;1419;3305;1039;31,437;0,058;27,707
SP02021;SP;4916;3842;1074;3403;978;28,739;0,055;25,455
SP02022;SP;2804;2154;650;1928;494;25,622;0,028;22,934
SP02023;SP;6925;5198;1727;4568;1282;28,065;0,072;24,663
SP02024;SP;5319;3670;1649;3406;789;23,165;0,044;21,499
SP02025;SP;4781;3417;1364;3169;809;25,529;0,046;23,676
SP02026;SP;6348;4500;1848;4105;984;23,971;0,055;21,867
SP02027;SP;5306;3655;1651;3293;785;23,838;0,044;21,477
SP02028;SP;7224;4975;2249;4430;1080;24,379;0,061;21,709
SP02029;SP;6908;4822;2086;4236;1026;24,221;0,058;21,277
SP02030;SP;7717;5529;2188;4903;1191;24,291;0,067;21,541
SP02031;SP;5725;4113;1612;3627;864;23,821;0,049;21,007
SP02032;SP;4842;3184;1658;2874;669;23,278;0,038;21,011
SP02033;SP;7687;5697;1990;5040;1283;25,456;0,072;22,521
SP02034;SP;6228;4543;1685;3999;926;23,156;0,052;20,383
SP02035;SP;4577;3611;966;3252;822;25,277;0,046;22,764
SP02036;SP;3622;2725;897;2505;579;23,114;0,033;21,248
SP02037;SP;3883;2872;1011;2546;618;24,273;0,035;21,518
SP02038;SP;5939;4569;1370;4230;1013;23,948;0,057;22,171
SP02039;SP;6572;4884;1688;4336;1039;23,962;0,058;21,274
SP02040;SP;2652;1987;665;1761;421;23,907;0,024;21,188
SP02041;SP;2020;1558;462;1393;354;25,413;0,020;22,721
SP02042;SP;2852;2039;813;1891;495;26,177;0,028;24,277
SP02043;SP;1561;1159;402;1061;280;26,390;0,016;24,159
SP02044;SP;1543;1193;350;1096;291;26,551;0,016;24,392
SP02045;SP;2296;1796;500;1622;445;27,435;0,025;24,777
SP02046;SP;1856;1432;424;1322;331;25,038;0,019;23,115
SP02047;SP;5031;3799;1232;3379;797;23,587;0,045;20,979
SP02048;SP;2701;2131;570;1857;484;26,064;0,027;22,712
SP02049;SP;2278;1738;540;1586;376;23,707;0,021;21,634
SP02050;SP;3558;2718;840;2454;580;23,635;0,033;21,339
SP02051;SP;4627;3564;1063;3321;846;25,474;0,048;23,737
SP02052;SP;4927;3580;1347;3222;731;22,688;0,041;20,419
SP02053;SP;3844;2932;912;2731;669;24,497;0,038;22,817
SP02054;SP;2287;1687;600;1502;406;27,031;0,023;24,066
SP02055;SP;1516;1161;355;1027;256;24,927;0,014;22,050
SP02056;SP;3560;2821;739;2626;694;26,428;0,039;24,601
SP02057;SP;3114;2324;790;2086;544;26,079;0,031;23,408
SP02058;SP;3951;2944;1007;2594;732;28,219;0,041;24,864
SP02059;SP;112;95;17;79;15;18,987;0,001;15,789
SP02060;SP;285;228;57;206;53;25,728;0,003;23,246
SP02061;SP;234;114;120;95;13;13,684;0,001;11,404
SP02062;SP;117;79;38;75;15;20,000;0,001;18,987
